"lang"
{
"Language"	"schinese"
"Tokens"
{
"Overlay_Splash_Hotkey"	"按 %hotkey% 以开始"
"[english]Overlay_Splash_Hotkey"	"Press %hotkey% to begin"
"Overlay_Splash_Message"	"在进行游戏时访问 Steam 社区。"
"[english]Overlay_Splash_Message"	"Access the Steam Community while playing."
"Overlay_SettingsTabTitle"	"游戏中"
"[english]Overlay_SettingsTabTitle"	"In-Game"
"Overlay_SettingsDescription"	"Steam 可以在您游戏中时保持活动状态，在您进行游戏时同样可以访问 Steam 社区的功能。"
"[english]Overlay_SettingsDescription"	"Steam can remain active while in-game, enabling access to Steam Community features while playing."
"Overlay_SettingsEnable"	"在游戏中启用 Steam 界面"
"[english]Overlay_SettingsEnable"	"Enable the Steam Overlay while in-game"
"Overlay_SettingsHotKeyLabel"	"界面快捷键"
"[english]Overlay_SettingsHotKeyLabel"	"Overlay shortcut keys"
"Overlay_WebBrowserTitle"	"游戏内网页浏览器"
"[english]Overlay_WebBrowserTitle"	"Web Browser In-Game"
"Overlay_Settings_Title"	"Steam - 设置"
"[english]Overlay_Settings_Title"	"Steam - Settings"
"Overlay_Taskbar_Friends"	"好友"
"[english]Overlay_Taskbar_Friends"	"Friends"
"Overlay_Taskbar_Settings"	"设置"
"[english]Overlay_Taskbar_Settings"	"Settings"
"Overlay_Taskbar_Players"	"玩家"
"[english]Overlay_Taskbar_Players"	"Players"
"Overlay_Taskbar_Achievements"	"成就"
"[english]Overlay_Taskbar_Achievements"	"Achievements"
"Overlay_Taskbar_News"	"新闻"
"[english]Overlay_Taskbar_News"	"News"
"Overlay_Taskbar_GameGroups"	"游戏组"
"[english]Overlay_Taskbar_GameGroups"	"Game Groups"
"Overlay_Taskbar_ChatRoom"	"聊天室"
"[english]Overlay_Taskbar_ChatRoom"	"Chat Room"
"Overlay_Taskbar_WebSite"	"网站"
"[english]Overlay_Taskbar_WebSite"	"Web Site"
"Overlay_Taskbar_Forums"	"讨论"
"[english]Overlay_Taskbar_Forums"	"Discussions"
"Overlay_Taskbar_Close"	"单击此处返回游戏"
"[english]Overlay_Taskbar_Close"	"Click here to return to the game"
"Overlay_Taskbar_WebBrowser"	"网页浏览器"
"[english]Overlay_Taskbar_WebBrowser"	"Web Browser"
"Overlay_Taskbar_DLC"	"DLC"
"[english]Overlay_Taskbar_DLC"	"DLC"
"Overlay_Taskbar_Guide"	"指南"
"[english]Overlay_Taskbar_Guide"	"Guide"
"Overlay_Taskbar_legacycdkey"	"游戏序列号"
"[english]Overlay_Taskbar_legacycdkey"	"CD Key"
"Overlay_Hotkey_Explain"	"也能关闭界面"
"[english]Overlay_Hotkey_Explain"	"also closes the overlay"
"Overlay_Playtime_Stats"	"游戏时间统计"
"[english]Overlay_Playtime_Stats"	"Playtime Stats"
"Overlay_Playtime_Intro"	"您玩过此游戏"
"[english]Overlay_Playtime_Intro"	"You've played this game"
"Overlay_Playtime_TwoWeeksHours"	"%hours_twoweeks% 小时 - 过去两周"
"[english]Overlay_Playtime_TwoWeeksHours"	"%hours_twoweeks% hours - past two weeks"
"Overlay_Playtime_TwoWeeksMinutes"	"%minutes_twoweeks% 分钟 - 过去两周"
"[english]Overlay_Playtime_TwoWeeksMinutes"	"%minutes_twoweeks% minutes - past two weeks"
"Overlay_Playtime_ForeverHours"	"%hours_forever% 小时 - 总计"
"[english]Overlay_Playtime_ForeverHours"	"%hours_forever% hours - total"
"Overlay_Playtime_ForeverMinutes"	"%minutes_forever% 分钟 - 总计"
"[english]Overlay_Playtime_ForeverMinutes"	"%minutes_forever% minutes - total"
"Overlay_Playtime_Session"	"%minutes_session% 分钟 - 当前游戏"
"[english]Overlay_Playtime_Session"	"%minutes_session% minutes - current session"
"Overlay_Friends_ThisManyOnline"	"您有 %numfriends% 位好友在线"
"[english]Overlay_Friends_ThisManyOnline"	"You have %numfriends% Friends online"
"Overlay_Friends_ThisManyInThisGame"	"您有 %numfriends% 位好友在此游戏服务器中"
"[english]Overlay_Friends_ThisManyInThisGame"	"You have %numfriends% Friends on this game server"
"Overlay_Friends_ViewAll"	"查看所有好友"
"[english]Overlay_Friends_ViewAll"	"View All Friends"
"Overlay_Friends_ViewPlayers"	"查看玩家"
"[english]Overlay_Friends_ViewPlayers"	"View Players"
"Overlay_Friends_ViewAchievements"	"查看所有成就"
"[english]Overlay_Friends_ViewAchievements"	"View All Achievements"
"Overlay_Friends_ViewNews"	"查看所有新闻"
"[english]Overlay_Friends_ViewNews"	"View All News"
"Overlay_Achievement_Title"	"成就 / %percent%%"
"[english]Overlay_Achievement_Title"	"Achievements / %percent%%"
"Overlay_Achievement_Progress"	"总共 %total% 个成就中您已完成了 %earned% 个"
"[english]Overlay_Achievement_Progress"	"You've earned %earned% out of %total% achievements"
"Overlay_Achievement_Recent"	"最近完成"
"[english]Overlay_Achievement_Recent"	"Most Recent"
"Overlay_Achievement_Soon"	"快完成了..."
"[english]Overlay_Achievement_Soon"	"So close..."
"Overlay_WebBrowser_Back"	"返回"
"[english]Overlay_WebBrowser_Back"	"BACK"
"Overlay_WebBrowser_Forward"	"前进"
"[english]Overlay_WebBrowser_Forward"	"FORWARD"
"Overlay_WebBrowser_Reload"	"重新读取"
"[english]Overlay_WebBrowser_Reload"	"RELOAD"
"Overlay_WebBrowser_Stop"	"停止"
"[english]Overlay_WebBrowser_Stop"	"STOP"
"Overlay_WebBrowser_Home"	"主页"
"[english]Overlay_WebBrowser_Home"	"HOME"
"steam_menu_friends_view"	"好友"
"[english]steam_menu_friends_view"	"Friends"
"steam_menu_friends_sortbyname"	"依姓名排序"
"[english]steam_menu_friends_sortbyname"	"Sort by Name"
"steam_menu_friends_showavatars"	"显示头像"
"[english]steam_menu_friends_showavatars"	"Show Avatars"
"steam_menu_friends_hideoffline"	"仅显示在线好友"
"[english]steam_menu_friends_hideoffline"	"Show Online Friends Only"
"steam_menu_friends_players"	"玩家"
"[english]steam_menu_friends_players"	"Players"
"steam_menu_friends_tools"	"工具"
"[english]steam_menu_friends_tools"	"Tools"
"steam_menu_friends_add"	"添加好友..."
"[english]steam_menu_friends_add"	"Add a Friend..."
"steam_menu_friends_settings"	"设置"
"[english]steam_menu_friends_settings"	"Settings"
"friends_searchOnline"	"搜索 Steam 社区成员"
"[english]friends_searchOnline"	"Search members of the Steam Community"
"Overlay_LowBattery_Message"	"电池电源的剩余供电时间为 %batteryTime% 分钟"
"[english]Overlay_LowBattery_Message"	"You have %batteryTime% minutes of battery power left"
"Overlay_CDKeyNotification_Message"	"如下所示，该 Steam 游戏需要一个特殊的产品序列号。当游戏要求输入时，请将其按此处所示键入。"
"[english]Overlay_CDKeyNotification_Message"	"This Steam game requires a special product key, shown below.  When the game asks for it, type it in as shown here."
"Overlay_CDKeyNotification_Message_MultipleKey"	"该 Steam 游戏需要多个产品序列号。当游戏要求要求输入时，可以按 %hotkey% 来查看您的产品序列号。"
"[english]Overlay_CDKeyNotification_Message_MultipleKey"	"This Steam game requires multiple product keys. When the game asks for one, you can press %hotkey% to view your product keys."
"Overlay_CDKeyNotification_CDKey"	"%cdkey%"
"[english]Overlay_CDKeyNotification_CDKey"	"%cdkey%"
"Overlay_CDKeyNotification_Hotkey"	"按 %hotkey% 以关闭此消息"
"[english]Overlay_CDKeyNotification_Hotkey"	"Press %hotkey% to close this message"
"Overlay_CDKeyNotification_Title"	"%gamename% 序列号"
"[english]Overlay_CDKeyNotification_Title"	"%gamename% CD key"
"Overlay_DontNotifyAgain"	"有关此类消息请勿再次提醒"
"[english]Overlay_DontNotifyAgain"	"Don't notify me about this again"
"Overlay_CDKeyDialog_NameColumn"	"物品"
"[english]Overlay_CDKeyDialog_NameColumn"	"Item"
"Overlay_CDKeyDialog_KeyColumn"	"产品代码"
"[english]Overlay_CDKeyDialog_KeyColumn"	"Product Code"
"Overlay_LobbyInvite_WrongGame_Title"	"游戏邀请"
"[english]Overlay_LobbyInvite_WrongGame_Title"	"Game Invitation"
"Overlay_LobbyInvite_WrongGame_Message"	"这是针对其它游戏的邀请，而非您当前运行的游戏。\n请关闭当前游戏，然后在桌面上接受此邀请。"
"[english]Overlay_LobbyInvite_WrongGame_Message"	"This invitation is for a different game than the one you're currently playing.\nPlease close your current game, and accept the invitation from your desktop."
"Overlay_MicroTxnAuth_Title"	"Steam 交易"
"[english]Overlay_MicroTxnAuth_Title"	"Steam Transaction"
"Overlay_MicroTxnAuth_Authorize"	"确定"
"[english]Overlay_MicroTxnAuth_Authorize"	"Authorize"
"Overlay_MicroTxnAuth_AddFunds"	"充值"
"[english]Overlay_MicroTxnAuth_AddFunds"	"Add Funds"
"Overlay_MicroTxnAuth_Cancel"	"取消"
"[english]Overlay_MicroTxnAuth_Cancel"	"Cancel"
"Overlay_MicroTxnAuth_Description"	"%game% 已请求下列项目的授权："
"[english]Overlay_MicroTxnAuth_Description"	"%game% has requested authorization for the following:"
"Overlay_MicroTxnAuth_Total"	"应付款总额"
"[english]Overlay_MicroTxnAuth_Total"	"Total due"
"Overlay_MicroTxnAuth_Header_Name"	"名称"
"[english]Overlay_MicroTxnAuth_Header_Name"	"Name"
"Overlay_MicroTxnAuth_Header_Price"	"价格"
"[english]Overlay_MicroTxnAuth_Header_Price"	"Price"
"Overlay_MicroTxnAuth_header_Quantity"	"数量"
"[english]Overlay_MicroTxnAuth_header_Quantity"	"Qty"
"Overlay_MicroTxnAuth_Balance"	"%balance%"
"[english]Overlay_MicroTxnAuth_Balance"	"%balance%"
"Overlay_MicroTxnAuth_BalanceLabel"	"您的余额"
"[english]Overlay_MicroTxnAuth_BalanceLabel"	"Your Balance"
"Overlay_MicroTxnAuth_Tax"	"税额"
"[english]Overlay_MicroTxnAuth_Tax"	"Tax"
"Overlay_AccessibilityNotification_Message"	"此功能需要在系统偏好设置中打开万能辅助。"
"[english]Overlay_AccessibilityNotification_Message"	"This feature requires Universal Access turned on from System Preferences."
"Overlay_MicroTxnCancelDlgTitle"	"取消交易"
"[english]Overlay_MicroTxnCancelDlgTitle"	"Cancel Transaction"
"Overlay_MicroTxnCancelDlgText"	"你确定要取消这次交易吗？"
"[english]Overlay_MicroTxnCancelDlgText"	"Are you sure you would like to cancel this transaction?"
"Overlay_MicroTxnCancelDlgOK"	"取消交易"
"[english]Overlay_MicroTxnCancelDlgOK"	"Cancel Transaction"
"Overlay_MicroTxnCancelDlgCancel"	"继续交易"
"[english]Overlay_MicroTxnCancelDlgCancel"	"Continue Transaction"
"Overlay_SettingsScreenshotHotKeyLabel"	"截图快捷键"
"[english]Overlay_SettingsScreenshotHotKeyLabel"	"Screenshot shortcut keys"
"Overlay_Taskbar_Recommend"	"推荐"
"[english]Overlay_Taskbar_Recommend"	"Recommend"
"Overlay_SettingsScreenshotActionLabel"	"截图截取完成时"
"[english]Overlay_SettingsScreenshotActionLabel"	"When a screenshot is taken"
"Overlay_Taskbar_Screenshots"	"截图"
"[english]Overlay_Taskbar_Screenshots"	"Screenshots"
"Overlay_Screenshots_Title"	"截图上传器"
"[english]Overlay_Screenshots_Title"	"Screenshot Uploader"
"Overlay_Screenshots_Panel_Title"	"截图"
"[english]Overlay_Screenshots_Panel_Title"	"Screenshots"
"Overlay_Screenshots_Show"	"查看："
"[english]Overlay_Screenshots_Show"	"Show: "
"Overlay_View_All_Screenshots"	"查看在线截图库"
"[english]Overlay_View_All_Screenshots"	"View online library"
"Overlay_View_Screenshots"	"查看截图"
"[english]Overlay_View_Screenshots"	"View screenshots"
"Overlay_View_Local"	"在硬盘中查看"
"[english]Overlay_View_Local"	"Show on disk"
"Overlay_Set_Shortcut"	"设置快捷键"
"[english]Overlay_Set_Shortcut"	"Set shortcut"
"Overlay_Publish"	"上传"
"[english]Overlay_Publish"	"Upload"
"Overlay_Delete"	"删除"
"[english]Overlay_Delete"	"Delete"
"Overlay_Details"	"在线查看"
"[english]Overlay_Details"	"View Online"
"Overlay_Current_Session"	"当前会话"
"[english]Overlay_Current_Session"	"Current session"
"Overlay_Last_Session"	"最近游戏"
"[english]Overlay_Last_Session"	"Last session"
"Overlay_Chars_Left"	"还可输入 %screenshot_caption_charsleft% 个字符"
"[english]Overlay_Chars_Left"	"%screenshot_caption_charsleft% chars left"
"Overlay_Add_Caption"	"添加说明"
"[english]Overlay_Add_Caption"	"Add a caption"
"Overlay_Publish_Offline"	"不能在离线模式下发布截图"
"[english]Overlay_Publish_Offline"	"Cannot publish screenshots in offline mode"
"Overlay_Screenshots_Press_Hotkey"	"按 %screenshot_hotkey% 键在游戏中截图。"
"[english]Overlay_Screenshots_Press_Hotkey"	"Press %screenshot_hotkey% while in-game to take screenshots."
"Overlay_Publish_Error_Title"	"错误"
"[english]Overlay_Publish_Error_Title"	"Error"
"Overlay_Publish_Error"	"上传截图时发生错误。请稍后再试。"
"[english]Overlay_Publish_Error"	"There was an error publishing the screenshot.  Please try again later."
"Overlay_Publish_Error_Quota"	"您没有足够剩余的云空间来上传这张截图"
"[english]Overlay_Publish_Error_Quota"	"You do not have enough Cloud space remaining to upload this screenshot"
"Overlay_Publish_Error_Quota_Plural"	"您没有足够剩余的云空间来上传这些截图"
"[english]Overlay_Publish_Error_Quota_Plural"	"You do not have enough Cloud space remaining to upload these screenshots"
"Overlay_Delete_Screenshot_Error"	"删除截图时发生错误。请稍后再试。"
"[english]Overlay_Delete_Screenshot_Error"	"There was an error deleting the screenshot.  Please try again later."
"Overlay_WebBrowser_OpenInNewTab"	"在新标签页中打开链接"
"[english]Overlay_WebBrowser_OpenInNewTab"	"Open Link In New Tab"
"Overlay_Share"	"分享到 Facebook"
"[english]Overlay_Share"	"Share to Facebook"
"Overlay_ToBeSharedToFacebook"	"若截图被分享到了 Facebook，它的可见性会改为“公开”。"
"[english]Overlay_ToBeSharedToFacebook"	"If this screenshot is shared to Facebook, it will have public visibility settings."
"Overlay_WontBeSharedToFacebook"	"多张截图无法同时分享到 Facebook。"
"[english]Overlay_WontBeSharedToFacebook"	"Multiple screenshots can't be shared to Facebook."
"Overlay_ScreenshotOnSteam"	"在 Steam 上查看此截图"
"[english]Overlay_ScreenshotOnSteam"	"Look at this screenshot on Steam"
"Overlay_ScreenshotOnSteamNamed"	"在 Steam 上查看 %gamename% 的截图"
"[english]Overlay_ScreenshotOnSteamNamed"	"Look at this screenshot of %gamename% on Steam"
"Overlay_PrivateScreenshot"	"此应用程序尚未公开。截图不能在 Steam 社区上公开，也不能分享到 Facebook。"
"[english]Overlay_PrivateScreenshot"	"This application is not public yet. Screenshots can't be made public on Steam Community and can't be shared to Facebook."
"Overlay_Screenshots_Size_Cloud"	"%selected_ss_size%"
"[english]Overlay_Screenshots_Size_Cloud"	"%selected_ss_size%"
"Overlay_Screenshots_Size_Original"	"（%selected_ss_size_original% 在硬盘中）"
"[english]Overlay_Screenshots_Size_Original"	" (%selected_ss_size_original% on disk)"
"Overlay_Taskbar_Workshop"	"创意工坊"
"[english]Overlay_Taskbar_Workshop"	"Workshop"
"Overlay_SettingsHomepageLabel"	"网页浏览器主页"
"[english]Overlay_SettingsHomepageLabel"	"Web browser home page"
"Overlay_Taskbar_GameHub"	"社区中心"
"[english]Overlay_Taskbar_GameHub"	"Community Hub"
"Overlay_SettingsTabTitleApp"	"应用程序中"
"[english]Overlay_SettingsTabTitleApp"	"In-application"
"Overlay_SettingsDescriptionApp"	"Steam 可以保持活动状态并为您提供“应用程序中”的 Steam 社区消息通知以及应用程序内完整的好友界面。"
"[english]Overlay_SettingsDescriptionApp"	"Steam can remain active and present you with in-application Steam Community message notifications as well as with a full friends interface inside your application."
"Overlay_SettingsEnableApp"	"启用“应用程序中”的 Steam 社区"
"[english]Overlay_SettingsEnableApp"	"Enable Steam Community In-Application"
"Overlay_WebBrowserTitleApp"	"“应用程序中”的网页浏览器"
"[english]Overlay_WebBrowserTitleApp"	"Web Browser In-Application"
"Overlay_Taskbar_CloseApp"	"单击此处返回应用程序"
"[english]Overlay_Taskbar_CloseApp"	"Click here to return to the application"
"Overlay_Playtime_IntroApp"	"您已运行过此应用程序"
"[english]Overlay_Playtime_IntroApp"	"You've run this application"
"Overlay_CDKeyNotification_MessageApp"	"此 Steam 应用程序需要专门的产品序列号，如下所示。当程序向您索要它时，请键入下方显示的序列号。"
"[english]Overlay_CDKeyNotification_MessageApp"	"This Steam application requires a special product key, shown below.  When the application asks for it, type it in as shown here."
"Overlay_CDKeyNotification_Message_MultipleKeyApp"	"此 Steam 应用程序需要多个产品序列号。当程序向您索要它们时，您可以按 %hotkey% 查看您的产品序列号。"
"[english]Overlay_CDKeyNotification_Message_MultipleKeyApp"	"This Steam application requires multiple product keys. When the application asks for one, you can press %hotkey% to view your product keys."
"Overlay_Screenshots_Press_HotkeyApp"	"按 %screenshot_hotkey% 键在应用程序中截图。"
"[english]Overlay_Screenshots_Press_HotkeyApp"	"Press %screenshot_hotkey% while in-application to take screenshots."
"Overlay_Tag_As_Potential_Spoiler"	"标记为剧透内容"
"[english]Overlay_Tag_As_Potential_Spoiler"	"Tag as potential spoiler"
"Overlay_Taskbar_SteamGuides"	"社区指南"
"[english]Overlay_Taskbar_SteamGuides"	"Community Guides"
"Overlay_Guides_Panel_Title"	"指南"
"[english]Overlay_Guides_Panel_Title"	"Guides"
"Overlay_View_Guides"	"浏览所有指南"
"[english]Overlay_View_Guides"	"View All Guides"
"Overlay_Guides_Panel_NumGuides"	"已发布 %num_guides% 篇"
"[english]Overlay_Guides_Panel_NumGuides"	"%num_guides% available"
"Overlay_CommunityHub_Panel_Title"	"社区中心"
"[english]Overlay_CommunityHub_Panel_Title"	"Community Hub"
"Overlay_View_CommunityHub"	"浏览社区中心"
"[english]Overlay_View_CommunityHub"	"View Community Hub"
"Overlay_CommunityHub_Panel_NumContributions"	"%num_contributions% 个社区投稿"
"[english]Overlay_CommunityHub_Panel_NumContributions"	"%num_contributions% Community Contributions"
"Overlay_CommunityDiscussions_Panel_Title"	"讨论"
"[english]Overlay_CommunityDiscussions_Panel_Title"	"Discussions"
"Overlay_View_CommunityDiscussions"	"浏览讨论"
"[english]Overlay_View_CommunityDiscussions"	"View Discussions"
"Overlay_CommunityDiscussions_Panel_NumDiscussions"	"%num_discussions% 个活动讨论"
"[english]Overlay_CommunityDiscussions_Panel_NumDiscussions"	"%num_discussions% active discussions"
"Overlay_MicroTxnSubscription"	"每 %time% 您需要支付 %cost%"
"[english]Overlay_MicroTxnSubscription"	"You will be charged %cost% every %time%"
"Overlay_MicroTxnSubscriptionYears"	"年"
"[english]Overlay_MicroTxnSubscriptionYears"	"year(s)"
"Overlay_MicroTxnSubscriptionMonths"	"个月"
"[english]Overlay_MicroTxnSubscriptionMonths"	"month(s)"
"Overlay_MicroTxnSubscriptionWeeks"	"周"
"[english]Overlay_MicroTxnSubscriptionWeeks"	"week(s)"
"Overlay_MicroTxnSubscriptionDays"	"天"
"[english]Overlay_MicroTxnSubscriptionDays"	"day(s)"
"Overlay_SaveUncompressed"	"保存未经压缩的副本"
"[english]Overlay_SaveUncompressed"	"Save an uncompressed copy"
"Overlay_SetScreenshotFolder"	"选择外部截图文件夹"
"[english]Overlay_SetScreenshotFolder"	"Select external screenshots folder"
"Overlay_SetScreenshotFolder_NoDriveRoot"	"您不能选择驱动盘的根目录"
"[english]Overlay_SetScreenshotFolder_NoDriveRoot"	"You may not select the root of a drive"
"Overlay_SetScreenshotFolder_InvalidFolder"	"您必须选择一个有效的截图文件夹路径"
"[english]Overlay_SetScreenshotFolder_InvalidFolder"	"You must select a valid screenshots folder"
"Overlay_FriendChangeConfirmation_Title"	"更改好友确认"
"[english]Overlay_FriendChangeConfirmation_Title"	"Friend Change Confirmation"
"Overlay_FriendChangeConfirmation_Confirm"	"确认更改"
"[english]Overlay_FriendChangeConfirmation_Confirm"	"Confirm Change"
"Overlay_FriendChangeConfirmation_Cancel"	"取消"
"[english]Overlay_FriendChangeConfirmation_Cancel"	"Cancel"
"Overlay_FriendChangeConfirmation_Reason_Add"	"您是否愿意添加 %persona% 至您的好友列表？"
"[english]Overlay_FriendChangeConfirmation_Reason_Add"	"Would you like to add %persona% to your Friends list?"
"Overlay_FriendChangeConfirmation_Button_Add"	"添加好友"
"[english]Overlay_FriendChangeConfirmation_Button_Add"	"Add Friend"
"Overlay_FriendChangeConfirmation_Reason_Remove"	"您是否愿意从好友列表中删除 %persona%？"
"[english]Overlay_FriendChangeConfirmation_Reason_Remove"	"Would you like to remove %persona% from your Friends list?"
"Overlay_FriendChangeConfirmation_Button_Remove"	"移除好友"
"[english]Overlay_FriendChangeConfirmation_Button_Remove"	"Remove Friend"
"Overlay_FriendChangeConfirmation_Reason_RequestAccept"	"您是否愿意接受 %persona% 的好友请求并将对方添加至您的好友列表？"
"[english]Overlay_FriendChangeConfirmation_Reason_RequestAccept"	"Would you like to accept the friend request from %persona% and add them to your Friends list?"
"Overlay_FriendChangeConfirmation_Button_RequestAccept"	"接受请求"
"[english]Overlay_FriendChangeConfirmation_Button_RequestAccept"	"Accept Request"
"Overlay_FriendChangeConfirmation_Reason_RequestIgnore"	"您是否愿意忽略来自 %persona% 的好友请求？"
"[english]Overlay_FriendChangeConfirmation_Reason_RequestIgnore"	"Would you like to ignore the friend request from %persona%?"
"Overlay_FriendChangeConfirmation_Button_RequestIgnore"	"忽略请求"
"[english]Overlay_FriendChangeConfirmation_Button_RequestIgnore"	"Ignore Request"
"Overlay_Publish_NeedWorkshopLegalAgreementAcceptance_Title"	"《Steam 创意工坊法律协议》"
"[english]Overlay_Publish_NeedWorkshopLegalAgreementAcceptance_Title"	"Steam Workshop Legal Agreement"
"Overlay_Publish_NeedWorkshopLegalAgreementAcceptance_Desc"	"在您的物品被完整发布之前，您必须接受最新的《Steam 创意工坊法律协议》。"
"[english]Overlay_Publish_NeedWorkshopLegalAgreementAcceptance_Desc"	"You need to accept the latest Steam Workshop Legal Agreement before your item is fully published."
"Overlay_Publish_NeedWorkshopLegalAgreementAcceptance_ViewItem"	"查看物品"
"[english]Overlay_Publish_NeedWorkshopLegalAgreementAcceptance_ViewItem"	"View item"
"Overlay_MicroTxnGameSubscription"	"这取决于您的游戏帐户"
"[english]Overlay_MicroTxnGameSubscription"	"as determined by your game account"
"Overlay_AsyncNotificatoinsRequestedDialog_Title"	"是否允许通知？"
"[english]Overlay_AsyncNotificatoinsRequestedDialog_Title"	"Allow notifications?"
"Overlay_AsyncNotificatoinsRequestedDialog_Allow"	"允许通知"
"[english]Overlay_AsyncNotificatoinsRequestedDialog_Allow"	"Allow notifications"
"Overlay_AsyncNotificatoinsRequestedDialog_Disallow"	"不允许"
"[english]Overlay_AsyncNotificatoinsRequestedDialog_Disallow"	"Disallow"
"Overlay_AsyncNotificatoinsRequestedDialog_Desc"	"此游戏支持异步游戏，允许您在回合之间关闭游戏。您是否想要在轮到您的回合时在 Steam 客户端接受通知？"
"[english]Overlay_AsyncNotificatoinsRequestedDialog_Desc"	"This game supports asynchronous gameplay, allowing you to close the game between your turns. Would you like to receive notifications in the Steam client when it is your turn to play?"
"Overlay_MicroTxnAuth_ConvertedTotalLabel"	"您将被收取"
"[english]Overlay_MicroTxnAuth_ConvertedTotalLabel"	"You will be charged"
"Overlay_MicroTxnAuth_ConvertedTotalValue"	"%converted_total%"
"[english]Overlay_MicroTxnAuth_ConvertedTotalValue"	"%converted_total%"
"Overlay_Taskbar_Music"	"音乐"
"[english]Overlay_Taskbar_Music"	"Music"
"Overlay_MicroTxnSubscriptionGame"	"*每 %time% 收取 %cost%"
"[english]Overlay_MicroTxnSubscriptionGame"	"*Billed %cost% every %time%"
"Overlay_Broadcast_Panel_Title"	"直播"
"[english]Overlay_Broadcast_Panel_Title"	"Broadcast"
"Overlay_Broadcast_Panel_Text"	"此直播当前有 %numviewers% 名观众"
"[english]Overlay_Broadcast_Panel_Text"	"This broadcast is currently followed by %numviewers% viewers"
"Overlay_Broadcast_ShowBroadcast"	"观看"
"[english]Overlay_Broadcast_ShowBroadcast"	"Watch"
"Overlay_Broadcast_ShowChat"	"打开聊天"
"[english]Overlay_Broadcast_ShowChat"	"Open Chat"
"Overlay_Broadcast_ShowSettings"	"设置"
"[english]Overlay_Broadcast_ShowSettings"	"Settings"
"Overlay_Broadcast_Stop"	"停止"
"[english]Overlay_Broadcast_Stop"	"Stop"
"Overlay_Broadcast_Chat_Title"	"直播 - 聊天（%numviewers%）"
"[english]Overlay_Broadcast_Chat_Title"	"Broadcast - Chat ( %numviewers%)"
"Overlay_Broadcast_Live_Debug"	"%videosendkbps% kbit/s, %videosendfps% FPS"
"[english]Overlay_Broadcast_Live_Debug"	"%videosendkbps% kbps, %videosendfps% FPS"
"Steam_Settings_Ingame_ShowFPS_Title"	"游戏中帧数显示"
"[english]Steam_Settings_Ingame_ShowFPS_Title"	"In-game FPS counter"
"Steam_Settings_Ingame_ShowFPS_Off"	"不显示"
"[english]Steam_Settings_Ingame_ShowFPS_Off"	"Off"
"Steam_Settings_Ingame_ShowFPS_LeftTop"	"左上角"
"[english]Steam_Settings_Ingame_ShowFPS_LeftTop"	"Top-left"
"Steam_Settings_Ingame_ShowFPS_RightTop"	"右上角"
"[english]Steam_Settings_Ingame_ShowFPS_RightTop"	"Top-right"
"Steam_Settings_Ingame_ShowFPS_RightBottom"	"右下角"
"[english]Steam_Settings_Ingame_ShowFPS_RightBottom"	"Bottom-right"
"Steam_Settings_Ingame_ShowFPS_LeftBottom"	"左下角"
"[english]Steam_Settings_Ingame_ShowFPS_LeftBottom"	"Bottom-left"
"Steam_Settings_Ingame_ShowFPS_HightContrast"	"高对比度颜色"
"[english]Steam_Settings_Ingame_ShowFPS_HightContrast"	"High contrast color"
"Overlay_MicroTxnAuth_RefundPeriod"	"在购买后的 48 小时内，Steam 可以在您未消耗、修改或转让这些物品的情况下提供退款。<a href=http://store.steampowered.com/steam_refunds>了解更多</a>"
"[english]Overlay_MicroTxnAuth_RefundPeriod"	"Steam offers refunds for these items within 48 hours of purchase if they have not been consumed, modified, or transferred. <a href=http://store.steampowered.com/steam_refunds>Learn More</a>"
"Overlay_MicroTxnAuth_NotRefundable"	"这些物品不符合退款要求。<a href=http://store.steampowered.com/steam_refunds>了解更多</a>"
"[english]Overlay_MicroTxnAuth_NotRefundable"	"These items are not eligible for a refund. <a href=http://store.steampowered.com/steam_refunds>Learn More</a>"
"Overlay_SettingsSCTenfootEnable"	"通过桌面使用启用了 Steam 输入的控制器时开启大屏幕界面"
"[english]Overlay_SettingsSCTenfootEnable"	"Use the Big Picture Overlay when using a Steam Input enabled controller from the desktop"
"Overlay_SettingsEnableVRDesktopGameTheaterCheck"	"在 SteamVR 作用时，通过桌面游乐剧院运行桌面游戏应用"
"[english]Overlay_SettingsEnableVRDesktopGameTheaterCheck"	"Use Desktop Game Theatre when launching desktop games while SteamVR is active"
"Overlay_SettingsDesktopGameTheaterCheck"	"在 SteamVR 作用时使用桌面游乐剧院"
"[english]Overlay_SettingsDesktopGameTheaterCheck"	"Use Desktop Game Theatre while SteamVR is active"
"Overlay_SettingsIsVRShortcut"	"纳入虚拟现实库"
"[english]Overlay_SettingsIsVRShortcut"	"Include in VR Library"
"Overlay_MicroTxnAuth_PayWithWallet"	"使用 Steam 钱包续订"
"[english]Overlay_MicroTxnAuth_PayWithWallet"	"Renew With Steam Wallet"
"Overlay_MicroTxnAuth_UpdateBillingInformation"	"更新账单信息"
"[english]Overlay_MicroTxnAuth_UpdateBillingInformation"	"Update Billing Info"
"Overlay_MicroTxnAuth_SubscriptionText"	"Steam 会在您的订阅更新时，自动使用您保存的支付方式结算。如果您没有存档的账单信息，Steam 会尝试从您钱包的资金中扣款。"
"[english]Overlay_MicroTxnAuth_SubscriptionText"	"Steam will automatically bill your stored payment method when your subscription renews. If you do not have billing information on file, Steam will attempt to use any funds in your wallet."
"Overlay_Taskbar_ForceQuit"	"强制退出"
"[english]Overlay_Taskbar_ForceQuit"	"Force Quit"
"Overlay_ForceQuit_Title"	"关闭应用程序"
"[english]Overlay_ForceQuit_Title"	"Close Application"
"Overlay_ForceQuit_Description"	"未保存的数据将丢失。"
"[english]Overlay_ForceQuit_Description"	"Unsaved data will be lost."
"Overlay_Taskbar_EditControllerConfig"	"控制器配置"
"[english]Overlay_Taskbar_EditControllerConfig"	"Controller Configuration"
"Steam_Settings_Library_Size_Automatic"	"自动"
"[english]Steam_Settings_Library_Size_Automatic"	"Automatic"
"Steam_Settings_Library_Size_Small"	"小"
"[english]Steam_Settings_Library_Size_Small"	"Small"
"Steam_Settings_Library_Size_Medium"	"中"
"[english]Steam_Settings_Library_Size_Medium"	"Medium"
"Steam_Settings_Library_Size_Large"	"大"
"[english]Steam_Settings_Library_Size_Large"	"Large"
"Steam_Settings_Library"	"库设置"
"[english]Steam_Settings_Library"	"Library Settings"
"Steam_Settings_Library_Size_Title"	"库用户界面元素显示大小"
"[english]Steam_Settings_Library_Size_Title"	"Display size for Library user interface elements"
"Steam_Settings_Library_Size_Automatic_Label"	"（元素大小由窗口宽度决定）"
"[english]Steam_Settings_Library_Size_Automatic_Label"	"(Element size determined by window width)"
"Steam_Settings_Library_LowBandwidth_Title"	"低带宽模式"
"[english]Steam_Settings_Library_LowBandwidth_Title"	"Low Bandwidth Mode"
"Steam_Settings_Library_LowBandwidth_Desc"	"禁用社区内容自动载入功能等以减少带宽使用"
"[english]Steam_Settings_Library_LowBandwidth_Desc"	"Reduces bandwidth use by disabling features like auto-load of community content."
"Steam_Settings_Library_LowPerf_Title"	"低性能模式"
"[english]Steam_Settings_Library_LowPerf_Title"	"Low Performance Mode"
"Steam_Settings_Library_LowPerf_Desc"	"禁用某些图像优化和转换以改善库性能"
"[english]Steam_Settings_Library_LowPerf_Desc"	"Improves library performance by disabling certain graphical improvements and transitions."
"SteamChina_Overlay_DurationControl_Init"	"健康游戏忠告\n抵制不良游戏，拒绝盗版游戏。注意自我保护，谨防受骗上当。\n适度游戏益脑，沉迷游戏伤身。合理安排时间，享受健康生活。"
"[english]SteamChina_Overlay_DurationControl_Init"	"Healthy Gaming Advisory\nBoycott harmful games; reject game piracy.\nExercise self-protection; avoid deception.\nModeration promotes brain health; excess play is harmful to the body.\nWell-planned use of your time will lead to a healthy lifestyle."
"SteamChina_Overlay_DurationControl_MessageA"	"您累计在线时间已满1小时。"
"[english]SteamChina_Overlay_DurationControl_MessageA"	"You've been playing for one hour."
"SteamChina_Overlay_DurationControl_MessageB"	"您累计在线时间已满3小时，\n请您下线休息，\n做适当身体活动。"
"[english]SteamChina_Overlay_DurationControl_MessageB"	"You've been playing for three hours.\nConsider taking a break."
"SteamChina_Overlay_DurationControl_MessageC"	"您已经进入疲劳游戏时间，\n您的游戏收益将降为正常值的50％，\n为了您的健康，请尽快下线休息，\n做适当身体活动，合理安排学习生活。"
"[english]SteamChina_Overlay_DurationControl_MessageC"	"You've been playing for over three hours.\nYour XP / progress has been reduced by half."
"SteamChina_Overlay_DurationControl_MessageD"	"您已进入不健康游戏时间，\n为了您的健康，请您立即下线休息。\n如不下线，您的身体将受到损害，\n您的收益已降为零，直到您的累计下线时间满5小时后，\n才能恢复正常。"
"[english]SteamChina_Overlay_DurationControl_MessageD"	"You've been playing for over five hours.\nYour XP / progress has been reduced to zero."
"SteamChina_Overlay_DurationControl_ExitSoon_3h"	"您本日累计游戏时间已达上限，\n请您休息调整，在次日8点后重新登录。"
"[english]SteamChina_Overlay_DurationControl_ExitSoon_3h"	"You have reached your limit of online time for today.\nPlease take a break and try tomorrow after 8AM."
"SteamChina_Overlay_DurationControl_ExitSoon_5h"	"您本日累计游戏时间已达上限，\n请您休息调整，在次日8点后重新登录。"
"[english]SteamChina_Overlay_DurationControl_ExitSoon_5h"	"You have reached your limit of online time for today.\nPlease take a break and try tomorrow after 8AM."
"Steam_Settings_Library_DisableCommunityContent_Title"	"禁用社区内容"
"[english]Steam_Settings_Library_DisableCommunityContent_Title"	"Disable Community Content"
"Steam_Settings_Library_DisableCommunityContent_Desc"	"防止在查看游戏详情时自动载入社区内容。"
"[english]Steam_Settings_Library_DisableCommunityContent_Desc"	"Prevents the automatic load of community content when viewing game details."
"Steam_Settings_Library_DisableCommunityContent_Disabled_Desc"	"由低带宽模式启用。\n\n防止在查看游戏详情时自动载入社区内容。"
"[english]Steam_Settings_Library_DisableCommunityContent_Disabled_Desc"	"Enabled by Low Bandwidth Mode.\n\nPrevents the automatic load of community content when viewing game details."
"Steam_Settings_Library_IconInGameList_Title"	"在左栏中显示游戏图标"
"[english]Steam_Settings_Library_IconInGameList_Title"	"Show game icons in the left column"
"SteamChina_Overlay_DurationControl_ExitSoon_Night"	"未满18周岁的用户在22点到次日8点\n无法进入游戏，请您注意休息。"
"[english]SteamChina_Overlay_DurationControl_ExitSoon_Night"	"Players under 18 can't play this game between 10PM\nand 8AM the following day. Please take a break."
}
}
