"lang"
{
"Language"	"dutch"
"Tokens"
{
"Overlay_Splash_Hotkey"	"Druk op %hotkey% om te beginnen"
"[english]Overlay_Splash_Hotkey"	"Press %hotkey% to begin"
"Overlay_Splash_Message"	"Tijdens het spelen naar de\nSteam Community."
"[english]Overlay_Splash_Message"	"Access the Steam Community while playing."
"Overlay_SettingsTabTitle"	"In spel"
"[english]Overlay_SettingsTabTitle"	"In-game"
"Overlay_SettingsDescription"	"Steam blijft actief en geeft je meldingen met Steam-communityberichten en een volledige vriendeninterface tijdens het spelen van een spel."
"[english]Overlay_SettingsDescription"	"Steam can remain active and present you with in-game Steam Community message notifications as well as with a full friends interface inside your game."
"Overlay_SettingsEnable"	"Steam Community tijdens het spelen inschakelen"
"[english]Overlay_SettingsEnable"	"Enable Steam Community In-Game"
"Overlay_SettingsHotKeyLabel"	"Sneltoets:"
"[english]Overlay_SettingsHotKeyLabel"	"Press shortcut keys:"
"Overlay_WebBrowserTitle"	"Webbrowser in spel"
"[english]Overlay_WebBrowserTitle"	"Web Browser In-Game"
"Overlay_Settings_Title"	"Steam - Instellingen"
"[english]Overlay_Settings_Title"	"Steam - Settings"
"Overlay_Taskbar_Friends"	"Vrienden"
"[english]Overlay_Taskbar_Friends"	"Friends"
"Overlay_Taskbar_Settings"	"Instellingen"
"[english]Overlay_Taskbar_Settings"	"Settings"
"Overlay_Taskbar_Players"	"Spelers"
"[english]Overlay_Taskbar_Players"	"Players"
"Overlay_Taskbar_Achievements"	"Prestaties"
"[english]Overlay_Taskbar_Achievements"	"Achievements"
"Overlay_Taskbar_News"	"Nieuws"
"[english]Overlay_Taskbar_News"	"News"
"Overlay_Taskbar_GameGroups"	"Spelgroepen"
"[english]Overlay_Taskbar_GameGroups"	"Game Groups"
"Overlay_Taskbar_ChatRoom"	"Chatroom"
"[english]Overlay_Taskbar_ChatRoom"	"Chat Room"
"Overlay_Taskbar_WebSite"	"Website"
"[english]Overlay_Taskbar_WebSite"	"Web Site"
"Overlay_Taskbar_Forums"	"Discussies"
"[english]Overlay_Taskbar_Forums"	"Discussions"
"Overlay_Taskbar_Close"	"Klik hier om terug te gaan naar het spel"
"[english]Overlay_Taskbar_Close"	"Click here to return to the game"
"Overlay_Taskbar_WebBrowser"	"Webbrowser"
"[english]Overlay_Taskbar_WebBrowser"	"Web Browser"
"Overlay_Taskbar_DLC"	"DLC"
"[english]Overlay_Taskbar_DLC"	"DLC"
"Overlay_Taskbar_Guide"	"Instructies"
"[english]Overlay_Taskbar_Guide"	"Guide"
"Overlay_Taskbar_legacycdkey"	"Cd-code"
"[english]Overlay_Taskbar_legacycdkey"	"CD Key"
"Overlay_Hotkey_Explain"	"sluit ook de overlay"
"[english]Overlay_Hotkey_Explain"	"also closes the overlay"
"Overlay_Playtime_Stats"	"Speeltijdstatistieken"
"[english]Overlay_Playtime_Stats"	"Playtime Stats"
"Overlay_Playtime_Intro"	"Je hebt dit spel gespeeld"
"[english]Overlay_Playtime_Intro"	"You've played this game"
"Overlay_Playtime_TwoWeeksHours"	"Afgelopen twee weken: %hours_twoweeks% uur gespeeld"
"[english]Overlay_Playtime_TwoWeeksHours"	"%hours_twoweeks% hours - past two weeks"
"Overlay_Playtime_TwoWeeksMinutes"	"Afgelopen twee weken: %minutes_twoweeks% minuten gespeeld"
"[english]Overlay_Playtime_TwoWeeksMinutes"	"%minutes_twoweeks% minutes - past two weeks"
"Overlay_Playtime_ForeverHours"	"In totaal: %hours_forever% uur gespeeld"
"[english]Overlay_Playtime_ForeverHours"	"%hours_forever% hours - total"
"Overlay_Playtime_ForeverMinutes"	"In totaal: %minutes_forever% minuten gespeeld"
"[english]Overlay_Playtime_ForeverMinutes"	"%minutes_forever% minutes - total"
"Overlay_Playtime_Session"	"Deze sessie: %minutes_session% minuten gespeeld"
"[english]Overlay_Playtime_Session"	"%minutes_session% minutes - current session"
"Overlay_Friends_ThisManyOnline"	"Er zijn %numfriends% vrienden online"
"[english]Overlay_Friends_ThisManyOnline"	"You have %numfriends% Friends online"
"Overlay_Friends_ThisManyInThisGame"	"Je hebt %numfriends% vrienden op deze gameserver"
"[english]Overlay_Friends_ThisManyInThisGame"	"You have %numfriends% Friends on this game server"
"Overlay_Friends_ViewAll"	"Alle vrienden weergeven"
"[english]Overlay_Friends_ViewAll"	"View All Friends"
"Overlay_Friends_ViewPlayers"	"Spelers weergeven"
"[english]Overlay_Friends_ViewPlayers"	"View Players"
"Overlay_Friends_ViewAchievements"	"Alle prestaties weergeven"
"[english]Overlay_Friends_ViewAchievements"	"View All Achievements"
"Overlay_Friends_ViewNews"	"Alle nieuws weergeven"
"[english]Overlay_Friends_ViewNews"	"View All News"
"Overlay_Achievement_Title"	"Prestaties / %percent%%"
"[english]Overlay_Achievement_Title"	"Achievements / %percent%%"
"Overlay_Achievement_Progress"	"Je hebt %earned% van de %total% prestaties bereikt"
"[english]Overlay_Achievement_Progress"	"You've earned %earned% out of %total% achievements"
"Overlay_Achievement_Recent"	"Meest recent"
"[english]Overlay_Achievement_Recent"	"Most Recent"
"Overlay_Achievement_Soon"	"Bijna..."
"[english]Overlay_Achievement_Soon"	"So close..."
"Overlay_WebBrowser_Back"	"TERUG"
"[english]Overlay_WebBrowser_Back"	"BACK"
"Overlay_WebBrowser_Forward"	"VOORUIT"
"[english]Overlay_WebBrowser_Forward"	"FORWARD"
"Overlay_WebBrowser_Reload"	"VERNIEUWEN"
"[english]Overlay_WebBrowser_Reload"	"RELOAD"
"Overlay_WebBrowser_Stop"	"STOPPEN"
"[english]Overlay_WebBrowser_Stop"	"STOP"
"Overlay_WebBrowser_Home"	"INTRODUCTIEPAGINA"
"[english]Overlay_WebBrowser_Home"	"HOME"
"steam_menu_friends_view"	"Vrienden"
"[english]steam_menu_friends_view"	"Friends"
"steam_menu_friends_sortbyname"	"Sorteren op naam"
"[english]steam_menu_friends_sortbyname"	"Sort by Name"
"steam_menu_friends_showavatars"	"Avatars weergeven"
"[english]steam_menu_friends_showavatars"	"Show Avatars"
"steam_menu_friends_hideoffline"	"Alleen vrienden weergeven die online zijn"
"[english]steam_menu_friends_hideoffline"	"Show Online Friends Only"
"steam_menu_friends_players"	"Spelers"
"[english]steam_menu_friends_players"	"Players"
"steam_menu_friends_tools"	"Tools"
"[english]steam_menu_friends_tools"	"Tools"
"steam_menu_friends_add"	"Een vriend toevoegen..."
"[english]steam_menu_friends_add"	"Add a Friend..."
"steam_menu_friends_settings"	"Instellingen"
"[english]steam_menu_friends_settings"	"Settings"
"friends_searchOnline"	"Leden van de Steam Community zoeken"
"[english]friends_searchOnline"	"Search members of the Steam Community"
"Overlay_LowBattery_Message"	"Je batterij gaat nog %batteryTime% ,minuten mee"
"[english]Overlay_LowBattery_Message"	"You have %batteryTime% minutes of battery power left"
"Overlay_CDKeyNotification_Message"	"Voor dit Steam-spel heb je een speciale productcode nodig. Als je hierom wordt gevraagd, vul je de code hieronder in."
"[english]Overlay_CDKeyNotification_Message"	"This Steam game requires a special product key, shown below.  When the game asks for it, type it in as shown here."
"Overlay_CDKeyNotification_Message_MultipleKey"	"Voor dit Steam-spel heb je meerdere productcodes nodig. Als je hierom wordt gevraagd, druk dan op %hotkey% om de codes te zien."
"[english]Overlay_CDKeyNotification_Message_MultipleKey"	"This Steam game requires multiple product keys. When the game asks for one, you can press %hotkey% to view your product keys."
"Overlay_CDKeyNotification_CDKey"	"%cdkey%"
"[english]Overlay_CDKeyNotification_CDKey"	"%cdkey%"
"Overlay_CDKeyNotification_Hotkey"	"Druk op %hotkey% om dit bericht te sluiten"
"[english]Overlay_CDKeyNotification_Hotkey"	"Press %hotkey% to close this message"
"Overlay_CDKeyNotification_Title"	"Cd-code van %gamename%"
"[english]Overlay_CDKeyNotification_Title"	"%gamename% CD key"
"Overlay_DontNotifyAgain"	"Deze waarschuwing niet meer weergeven"
"[english]Overlay_DontNotifyAgain"	"Don't notify me about this again"
"Overlay_CDKeyDialog_NameColumn"	"Item"
"[english]Overlay_CDKeyDialog_NameColumn"	"Item"
"Overlay_CDKeyDialog_KeyColumn"	"Productcode"
"[english]Overlay_CDKeyDialog_KeyColumn"	"Product Code"
"Overlay_LobbyInvite_WrongGame_Title"	"Speluitnodiging"
"[english]Overlay_LobbyInvite_WrongGame_Title"	"Game Invitation"
"Overlay_LobbyInvite_WrongGame_Message"	"Deze uitnodiging is voor een ander spel dan het spel dat je op dit moment speelt.\nSluit het huidige spel en accepteer de uitnodiging via je bureaublad."
"[english]Overlay_LobbyInvite_WrongGame_Message"	"This invitation is for a different game than the one you're currently playing.\nPlease close your current game, and accept the invitation from your desktop."
"Overlay_MicroTxnAuth_Title"	"Steam-transactie"
"[english]Overlay_MicroTxnAuth_Title"	"Steam Transaction"
"Overlay_MicroTxnAuth_Authorize"	"Goedkeuren"
"[english]Overlay_MicroTxnAuth_Authorize"	"Authorize"
"Overlay_MicroTxnAuth_AddFunds"	"Saldo toevoegen"
"[english]Overlay_MicroTxnAuth_AddFunds"	"Add Funds"
"Overlay_MicroTxnAuth_Cancel"	"Annuleren"
"[english]Overlay_MicroTxnAuth_Cancel"	"Cancel"
"Overlay_MicroTxnAuth_Description"	"%game% heeft goedkeuring aangevraagd voor het volgende:"
"[english]Overlay_MicroTxnAuth_Description"	"%game% has requested authorization for the following:"
"Overlay_MicroTxnAuth_Total"	"Totaal verschuldigd"
"[english]Overlay_MicroTxnAuth_Total"	"Total due"
"Overlay_MicroTxnAuth_Header_Name"	"Naam"
"[english]Overlay_MicroTxnAuth_Header_Name"	"Name"
"Overlay_MicroTxnAuth_Header_Price"	"Prijs"
"[english]Overlay_MicroTxnAuth_Header_Price"	"Price"
"Overlay_MicroTxnAuth_header_Quantity"	"Aantal"
"[english]Overlay_MicroTxnAuth_header_Quantity"	"Qty"
"Overlay_MicroTxnAuth_Balance"	"%balance%"
"[english]Overlay_MicroTxnAuth_Balance"	"%balance%"
"Overlay_MicroTxnAuth_BalanceLabel"	"Jouw saldo"
"[english]Overlay_MicroTxnAuth_BalanceLabel"	"Your Balance"
"Overlay_MicroTxnAuth_Tax"	"Belasting"
"[english]Overlay_MicroTxnAuth_Tax"	"Tax"
"Overlay_AccessibilityNotification_Message"	"Deze functie vereist dat Universele Toegang aan staat in Systeem Voorkeuren."
"[english]Overlay_AccessibilityNotification_Message"	"This feature requires Universal Access turned on from System Preferences."
"Overlay_MicroTxnCancelDlgTitle"	"Transactie annuleren"
"[english]Overlay_MicroTxnCancelDlgTitle"	"Cancel Transaction"
"Overlay_MicroTxnCancelDlgText"	"Weet je zeker dat je deze transactie wilt annuleren?"
"[english]Overlay_MicroTxnCancelDlgText"	"Are you sure you would like to cancel this transaction?"
"Overlay_MicroTxnCancelDlgOK"	"Transactie annuleren"
"[english]Overlay_MicroTxnCancelDlgOK"	"Cancel Transaction"
"Overlay_MicroTxnCancelDlgCancel"	"Doorgaan met transactie"
"[english]Overlay_MicroTxnCancelDlgCancel"	"Continue Transaction"
"Overlay_SettingsScreenshotHotKeyLabel"	"Screenshotsneltoets:"
"[english]Overlay_SettingsScreenshotHotKeyLabel"	"Screenshot shortcut keys:"
"Overlay_Taskbar_Recommend"	"Aanbevelen"
"[english]Overlay_Taskbar_Recommend"	"Recommend"
"Overlay_SettingsScreenshotActionLabel"	"Wanneer een screenshot is gemaakt:"
"[english]Overlay_SettingsScreenshotActionLabel"	"When a screenshot is taken"
"Overlay_Taskbar_Screenshots"	"Screenshots"
"[english]Overlay_Taskbar_Screenshots"	"Screenshots"
"Overlay_Screenshots_Title"	"Screenshotuploader"
"[english]Overlay_Screenshots_Title"	"Screenshot Uploader"
"Overlay_Screenshots_Panel_Title"	"Screenshots"
"[english]Overlay_Screenshots_Panel_Title"	"Screenshots"
"Overlay_Screenshots_Show"	"Toon:"
"[english]Overlay_Screenshots_Show"	"Show: "
"Overlay_View_All_Screenshots"	"Online bekijken"
"[english]Overlay_View_All_Screenshots"	"View online library"
"Overlay_View_Screenshots"	"Screenshots weergeven"
"[english]Overlay_View_Screenshots"	"View screenshots"
"Overlay_View_Local"	"Op schijf tonen"
"[english]Overlay_View_Local"	"Show on disk"
"Overlay_Set_Shortcut"	"Sneltoets instellen"
"[english]Overlay_Set_Shortcut"	"Set shortcut"
"Overlay_Publish"	"Uploaden"
"[english]Overlay_Publish"	"Upload"
"Overlay_Delete"	"Verwijderen"
"[english]Overlay_Delete"	"Delete"
"Overlay_Details"	"Online bekijken"
"[english]Overlay_Details"	"View Online"
"Overlay_Current_Session"	"Huidige sessie"
"[english]Overlay_Current_Session"	"Current session"
"Overlay_Last_Session"	"Laatste sessie"
"[english]Overlay_Last_Session"	"Last session"
"Overlay_Chars_Left"	"%screenshot_caption_charsleft% tekens resterend"
"[english]Overlay_Chars_Left"	"%screenshot_caption_charsleft% chars left"
"Overlay_Add_Caption"	"Een bijschrift toevoegen"
"[english]Overlay_Add_Caption"	"Add a caption"
"Overlay_Publish_Offline"	"Kan geen screenshots publiceren in offline-modus"
"[english]Overlay_Publish_Offline"	"Cannot publish screenshots in offline mode"
"Overlay_Screenshots_Press_Hotkey"	"Druk tijdens het spelen van een spel op %screenshot_hotkey% om een screenshot te maken."
"[english]Overlay_Screenshots_Press_Hotkey"	"Press %screenshot_hotkey% while in-game to take screenshots."
"Overlay_Publish_Error_Title"	"Fout"
"[english]Overlay_Publish_Error_Title"	"Error"
"Overlay_Publish_Error"	"Er is een fout opgetreden bij het publiceren van het screenshot. Probeer het later nog eens."
"[english]Overlay_Publish_Error"	"There was an error publishing the screenshot.  Please try again later."
"Overlay_Publish_Error_Quota"	"Je hebt niet genoeg ruimte op de Cloud over om dit screenshot te uploaden"
"[english]Overlay_Publish_Error_Quota"	"You do not have enough Cloud space remaining to upload this screenshot"
"Overlay_Publish_Error_Quota_Plural"	"Je hebt niet genoeg ruimte op de Cloud over om deze screenshots te uploaden"
"[english]Overlay_Publish_Error_Quota_Plural"	"You do not have enough Cloud space remaining to upload these screenshots"
"Overlay_Delete_Screenshot_Error"	"Er is een fout opgetreden bij het verwijderen van het screenshot. Probeer het later nog eens."
"[english]Overlay_Delete_Screenshot_Error"	"There was an error deleting the screenshot.  Please try again later."
"Overlay_WebBrowser_OpenInNewTab"	"Link in nieuw tabblad openen"
"[english]Overlay_WebBrowser_OpenInNewTab"	"Open Link In New Tab"
"Overlay_Share"	"Op Facebook delen"
"[english]Overlay_Share"	"Share to Facebook"
"Overlay_ToBeSharedToFacebook"	"Als dit screenshot op Facebook wordt gedeeld is het openbaar."
"[english]Overlay_ToBeSharedToFacebook"	"If this screenshot is shared to Facebook, it will have public visibility settings."
"Overlay_WontBeSharedToFacebook"	"Je kan niet meerdere screenshots op Facebook delen."
"[english]Overlay_WontBeSharedToFacebook"	"Multiple screenshots can't be shared to Facebook."
"Overlay_ScreenshotOnSteam"	"Dit screenshot op Steam bekijken"
"[english]Overlay_ScreenshotOnSteam"	"Look at this screenshot on Steam"
"Overlay_ScreenshotOnSteamNamed"	"Bekijk dit screenshot van %gamename% op Steam"
"[english]Overlay_ScreenshotOnSteamNamed"	"Look at this screenshot of %gamename% on Steam"
"Overlay_PrivateScreenshot"	"Deze applicatie is nog niet openbaar. Screenshots kunnen niet openbaar gemaakt worden op de Steam Community en kunnen niet gedeeld worden naar Facebook."
"[english]Overlay_PrivateScreenshot"	"This application is not public yet. Screenshots can't be made public on Steam Community and can't be shared to Facebook."
"Overlay_Screenshots_Size_Cloud"	"%selected_ss_size%"
"[english]Overlay_Screenshots_Size_Cloud"	"%selected_ss_size%"
"Overlay_Screenshots_Size_Original"	" (%selected_ss_size_original% op schijf)"
"[english]Overlay_Screenshots_Size_Original"	" (%selected_ss_size_original% on disk)"
"Overlay_Taskbar_Workshop"	"Workshop"
"[english]Overlay_Taskbar_Workshop"	"Workshop"
"Overlay_SettingsHomepageLabel"	"Startpagina browser"
"[english]Overlay_SettingsHomepageLabel"	"Browser Home Page"
"Overlay_Taskbar_GameHub"	"Communityhub"
"[english]Overlay_Taskbar_GameHub"	"Community Hub"
"Overlay_SettingsTabTitleApp"	"In programma"
"[english]Overlay_SettingsTabTitleApp"	"In-application"
"Overlay_SettingsDescriptionApp"	"Steam blijft actief en geeft je meldingen met Steam-communityberichten en een volledige vriendeninterface tijdens het gebruiken van een programma."
"[english]Overlay_SettingsDescriptionApp"	"Steam can remain active and present you with in-application Steam Community message notifications as well as with a full friends interface inside your application."
"Overlay_SettingsEnableApp"	"Steam Community tijdens gebruik van programma inschakelen"
"[english]Overlay_SettingsEnableApp"	"Enable Steam Community In-Application"
"Overlay_WebBrowserTitleApp"	"Webbrowser in programma"
"[english]Overlay_WebBrowserTitleApp"	"Web Browser In-Application"
"Overlay_Taskbar_CloseApp"	"Klik hier om terug te gaan naar het spel"
"[english]Overlay_Taskbar_CloseApp"	"Click here to return to the application"
"Overlay_Playtime_IntroApp"	"Je hebt dit programma gebruikt"
"[english]Overlay_Playtime_IntroApp"	"You've run this application"
"Overlay_CDKeyNotification_MessageApp"	"Voor dit Steam-programma heb je een speciale productcode nodig. Als je hierom wordt gevraagd, vul je de code hieronder in."
"[english]Overlay_CDKeyNotification_MessageApp"	"This Steam application requires a special product key, shown below.  When the application asks for it, type it in as shown here."
"Overlay_CDKeyNotification_Message_MultipleKeyApp"	"Voor dit Steam-programma heb je meerdere productcodes nodig. Als je hierom wordt gevraagd, druk dan op %hotkey% om de codes te zien."
"[english]Overlay_CDKeyNotification_Message_MultipleKeyApp"	"This Steam application requires multiple product keys. When the application asks for one, you can press %hotkey% to view your product keys."
"Overlay_Screenshots_Press_HotkeyApp"	"Druk tijdens het gebruik van een programma op %screenshot_hotkey% om een screenshot te maken."
"[english]Overlay_Screenshots_Press_HotkeyApp"	"Press %screenshot_hotkey% while in-application to take screenshots."
"Overlay_Tag_As_Potential_Spoiler"	"Als mogelijke spoiler markeren"
"[english]Overlay_Tag_As_Potential_Spoiler"	"Tag as potential spoiler"
"Overlay_Taskbar_SteamGuides"	"Communitygidsen"
"[english]Overlay_Taskbar_SteamGuides"	"Community Guides"
"Overlay_Guides_Panel_Title"	"Gidsen"
"[english]Overlay_Guides_Panel_Title"	"Guides"
"Overlay_View_Guides"	"Alle gidsen weergeven"
"[english]Overlay_View_Guides"	"View All Guides"
"Overlay_Guides_Panel_NumGuides"	"%num_guides% beschikbaar"
"[english]Overlay_Guides_Panel_NumGuides"	"%num_guides% available"
"Overlay_CommunityHub_Panel_Title"	"Communityhub"
"[english]Overlay_CommunityHub_Panel_Title"	"Community Hub"
"Overlay_View_CommunityHub"	"Communityhub weergeven"
"[english]Overlay_View_CommunityHub"	"View Community Hub"
"Overlay_CommunityHub_Panel_NumContributions"	"%num_contributions% communitybijdragen"
"[english]Overlay_CommunityHub_Panel_NumContributions"	"%num_contributions% Community Contributions"
"Overlay_CommunityDiscussions_Panel_Title"	"Discussies"
"[english]Overlay_CommunityDiscussions_Panel_Title"	"Discussions"
"Overlay_View_CommunityDiscussions"	"Discussies weergeven"
"[english]Overlay_View_CommunityDiscussions"	"View Discussions"
"Overlay_CommunityDiscussions_Panel_NumDiscussions"	"%num_discussions% actieve discussies"
"[english]Overlay_CommunityDiscussions_Panel_NumDiscussions"	"%num_discussions% active discussions"
"Overlay_MicroTxnSubscription"	"Er wordt elke %time% %acct% %cost% in rekening gebracht."
"[english]Overlay_MicroTxnSubscription"	"You will be charged %cost% every %time% %acct%"
"Overlay_MicroTxnSubscriptionYears"	"jaar"
"[english]Overlay_MicroTxnSubscriptionYears"	"year(s)"
"Overlay_MicroTxnSubscriptionMonths"	"maand(en)"
"[english]Overlay_MicroTxnSubscriptionMonths"	"month(s)"
"Overlay_MicroTxnSubscriptionWeeks"	"week/weken"
"[english]Overlay_MicroTxnSubscriptionWeeks"	"week(s)"
"Overlay_MicroTxnSubscriptionDays"	"dag(en)"
"[english]Overlay_MicroTxnSubscriptionDays"	"day(s)"
"Overlay_SaveUncompressed"	"Een ongecomprimeerde kopie buiten Steam opslaan"
"[english]Overlay_SaveUncompressed"	"Save an uncompressed copy outside of Steam"
"Overlay_SetScreenshotFolder"	"Selecteer een externe map voor screenshots"
"[english]Overlay_SetScreenshotFolder"	"Select external screenshots folder"
"Overlay_SetScreenshotFolder_NoDriveRoot"	"Je mag de root van een schijf niet selecteren"
"[english]Overlay_SetScreenshotFolder_NoDriveRoot"	"You may not select the root of a drive"
"Overlay_SetScreenshotFolder_InvalidFolder"	"Je moet een geldige screenshotmap kiezen"
"[english]Overlay_SetScreenshotFolder_InvalidFolder"	"You must select a valid screenshots folder"
"Overlay_FriendChangeConfirmation_Title"	"Bevestiging van vriendschapswijziging"
"[english]Overlay_FriendChangeConfirmation_Title"	"Friend Change Confirmation"
"Overlay_FriendChangeConfirmation_Confirm"	"Wijziging bevestigen"
"[english]Overlay_FriendChangeConfirmation_Confirm"	"Confirm Change"
"Overlay_FriendChangeConfirmation_Cancel"	"Annuleren"
"[english]Overlay_FriendChangeConfirmation_Cancel"	"Cancel"
"Overlay_FriendChangeConfirmation_Reason_Add"	"Wil je %persona% aan je vriendenlijst toevoegen?"
"[english]Overlay_FriendChangeConfirmation_Reason_Add"	"Would you like to add %persona% to your Friends list?"
"Overlay_FriendChangeConfirmation_Button_Add"	"Toevoegen als vriend"
"[english]Overlay_FriendChangeConfirmation_Button_Add"	"Add Friend"
"Overlay_FriendChangeConfirmation_Reason_Remove"	"Wil je %persona% uit je vriendenlijst verwijderen?"
"[english]Overlay_FriendChangeConfirmation_Reason_Remove"	"Would you like to remove %persona% from your Friends list?"
"Overlay_FriendChangeConfirmation_Button_Remove"	"Vriend verwijderen"
"[english]Overlay_FriendChangeConfirmation_Button_Remove"	"Remove Friend"
"Overlay_FriendChangeConfirmation_Reason_RequestAccept"	"Wil je het vriendenverzoek van %persona% accepteren en hem of haar toevoegen aan je vriendenlijst?"
"[english]Overlay_FriendChangeConfirmation_Reason_RequestAccept"	"Would you like to accept the friend request from %persona% and add them to your Friends list?"
"Overlay_FriendChangeConfirmation_Button_RequestAccept"	"Verzoek accepteren"
"[english]Overlay_FriendChangeConfirmation_Button_RequestAccept"	"Accept Request"
"Overlay_FriendChangeConfirmation_Reason_RequestIgnore"	"Wil je het vriendenverzoek van %persona% negeren?"
"[english]Overlay_FriendChangeConfirmation_Reason_RequestIgnore"	"Would you like to ignore the friend request from %persona%?"
"Overlay_FriendChangeConfirmation_Button_RequestIgnore"	"Verzoek negeren"
"[english]Overlay_FriendChangeConfirmation_Button_RequestIgnore"	"Ignore Request"
"Overlay_Publish_NeedWorkshopLegalAgreementAcceptance_Title"	"Steam Workshop-voorwaarden"
"[english]Overlay_Publish_NeedWorkshopLegalAgreementAcceptance_Title"	"Steam Workshop Legal Agreement"
"Overlay_Publish_NeedWorkshopLegalAgreementAcceptance_Desc"	"Je moet akkoord gaan met de nieuwe Steam Workshop-voorwaarden alvorens je voorwerp wordt gepubliceerd."
"[english]Overlay_Publish_NeedWorkshopLegalAgreementAcceptance_Desc"	"You need to accept the latest Steam Workshop Legal Agreement before your item is fully published."
"Overlay_Publish_NeedWorkshopLegalAgreementAcceptance_ViewItem"	"Item weergeven"
"[english]Overlay_Publish_NeedWorkshopLegalAgreementAcceptance_ViewItem"	"View item"
"Overlay_MicroTxnGameSubscription"	"zoals bepaald door je spelaccount"
"[english]Overlay_MicroTxnGameSubscription"	"as determined by your game account"
}
}
