"lang"
{
"Language"	"hungarian"
"Tokens"
{
"TextEntry_Cut"	"Kivágás"
"[english]TextEntry_Cut"	"Cut"
"TextEntry_Copy"	"Másolás"
"[english]TextEntry_Copy"	"Copy"
"TextEntry_Paste"	"Beillesztés"
"[english]TextEntry_Paste"	"Paste"
"TextEntry_SelectAll"	"Összes kijelölése"
"[english]TextEntry_SelectAll"	"Select all"
"FileOpenDialog_Open"	"Megnyitás"
"[english]FileOpenDialog_Open"	"Open"
"FileOpenDialog_Cancel"	"Mégse"
"[english]FileOpenDialog_Cancel"	"Cancel"
"FileOpenDialog_Look_in"	"Tallózás:"
"[english]FileOpenDialog_Look_in"	"Look in:"
"FileOpenDialog_File_Name"	"Fájlnév:"
"[english]FileOpenDialog_File_Name"	"File name:"
"FileOpenDialog_File_Type"	"Fájltípus:"
"[english]FileOpenDialog_File_Type"	"File type:"
"FileOpenDialog_Icon"	" "
"[english]FileOpenDialog_Icon"	" "
"FileOpenDialog_Name"	"Név"
"[english]FileOpenDialog_Name"	"Name"
"FileOpenDialog_Type"	"Típus"
"[english]FileOpenDialog_Type"	"Type"
"SysMenu_Minimize"	" Kis méret "
"[english]SysMenu_Minimize"	" Minimize "
"SysMenu_Maximize"	" Nagy méret "
"[english]SysMenu_Maximize"	" Maximize "
"SysMenu_Close"	" Bezárás "
"[english]SysMenu_Close"	" Close "
"Frame_Untitled"	"Névtelen"
"[english]Frame_Untitled"	"Untitled"
"MessageBox_OK"	"OK"
"[english]MessageBox_OK"	"OK"
"PropertyDialog_OK"	"OK"
"[english]PropertyDialog_OK"	"OK"
"PropertyDialog_Cancel"	"Mégse"
"[english]PropertyDialog_Cancel"	"Cancel"
"PropertyDialog_Apply"	"Alkalmaz"
"[english]PropertyDialog_Apply"	"Apply"
"QueryBox_Cancel"	"Mégse"
"[english]QueryBox_Cancel"	"Cancel"
"WizardPanel_Next"	"Következő >"
"[english]WizardPanel_Next"	"Next >"
"WizardPanel_Back"	"< Előző"
"[english]WizardPanel_Back"	"< Back"
"WizardPanel_Finish"	"Befejezés"
"[english]WizardPanel_Finish"	"Finish"
"WizardPanel_Cancel"	"Mégse"
"[english]WizardPanel_Cancel"	"Cancel"
"vgui_ok"	"OK"
"[english]vgui_ok"	"OK"
"vgui_close"	"Bezárás"
"[english]vgui_close"	"Close"
"vgui_Cancel"	"Mégse"
"[english]vgui_Cancel"	"Cancel"
"vgui_select"	"Kijelölés"
"[english]vgui_select"	"Select"
"vgui_createfolder"	"Új mappa..."
"[english]vgui_createfolder"	"New Folder..."
"vgui_next"	"Következő >"
"[english]vgui_next"	"Next >"
"vgui_back"	"< Előző"
"[english]vgui_back"	"< Back"
"vgui_CreateDirectoryFail_Title"	"Könyvtárlétrehozás - Hiba"
"[english]vgui_CreateDirectoryFail_Title"	"Create Folder - Error"
"vgui_CreateDirectoryFail_Info"	"Könyvtárlétrehozás sikertelen, a meghajtó írásvédett."
"[english]vgui_CreateDirectoryFail_Info"	"Failed to create a folder, this drive is read-only."
"vgui_CreateDirectoryFail_AlreadyExists"	"A mappa már létezik."
"[english]vgui_CreateDirectoryFail_AlreadyExists"	"That folder already exists."
"TextEntry_Language"	"Nyelv"
"[english]TextEntry_Language"	"Language"
"TextEntry_ConversionMode"	"Konvertálási mód"
"[english]TextEntry_ConversionMode"	"Conversion Mode"
"TextEntry_SentenceMode"	"Mondat mód"
"[english]TextEntry_SentenceMode"	"Sentence Mode"
"IME_English"	"Angol"
"[english]IME_English"	"English"
"IME_Chinese"	"Kínai"
"[english]IME_Chinese"	"Chinese"
"IME_Korean"	"Koreai"
"[english]IME_Korean"	"Korean"
"IME_Hiragana"	"Hiragana"
"[english]IME_Hiragana"	"Hiragana"
"IME_FullWidthKatakana"	"Teljes szélességű katakana"
"[english]IME_FullWidthKatakana"	"Full-width Katakana"
"IME_FullWidthAlphanumeric"	"Teljes szélességű alfanumerikus"
"[english]IME_FullWidthAlphanumeric"	"Full-width Alphanumeric"
"IME_HalfWidthKatakana"	"Félszélességű katakana"
"[english]IME_HalfWidthKatakana"	"Half-width Katakana"
"IME_HalfWidthAlphanumeric"	"Félszélességű alfanumerikus"
"[english]IME_HalfWidthAlphanumeric"	"Half-width Alphanumeric"
"IME_General"	"Általános"
"[english]IME_General"	"General"
"IME_BiasNames"	"Hangsúly a neveken"
"[english]IME_BiasNames"	"Bias for Names"
"IME_BiasSpeech"	"Hangsúly a beszéden"
"[english]IME_BiasSpeech"	"Bias for Speech"
"IME_NoConversion"	"Konvertálás nélkül"
"[english]IME_NoConversion"	"No Conversion"
"IME_0404"	"Kínai (Taiwan)"
"[english]IME_0404"	"Chinese (Taiwan)"
"IME_0804"	"Kínai (Kínai Népköztársaság)"
"[english]IME_0804"	"Chinese (PRC)"
"IME_0409"	"Angol (USA)"
"[english]IME_0409"	"English (United States)"
"IME_0411"	"Japán"
"[english]IME_0411"	"Japanese"
"IME_0412"	"Koreai"
"[english]IME_0412"	"Korean"
"IME_0419"	"Orosz"
"[english]IME_0419"	"Russian"
"IME_041e"	"Thai"
"[english]IME_041e"	"Thai"
"IME_040c"	"Francia (Standard)"
"[english]IME_040c"	"French (Standard)"
"IME_0407"	"Német (Standard)"
"[english]IME_0407"	"German (Standard)"
"IME_0410"	"Olasz (Standard)"
"[english]IME_0410"	"Italian (Standard)"
"IME_040a"	"Spanyol (Spanyolország, Hagyományos kiosztás)"
"[english]IME_040a"	"Spanish (Spain, Traditional Sort)"
"vgui_FileCopyDialog_Title"	"Másolás..."
"[english]vgui_FileCopyDialog_Title"	"Copying..."
"vgui_FileMoveDialog_Title"	"Áthelyezés..."
"[english]vgui_FileMoveDialog_Title"	"Moving..."
"vgui_FileCopy_Estimate"	"%s1 van hátra"
"[english]vgui_FileCopy_Estimate"	"%s1 remaining"
"vgui_FileCopy_Copying_Multiple"	"„%s1” másolása (%s2 van hátra)"
"[english]vgui_FileCopy_Copying_Multiple"	"Copying '%s1' (%s2 remaining)"
"vgui_FileCopy_Copying_Single"	"„%s1” másolása"
"[english]vgui_FileCopy_Copying_Single"	"Copying '%s1'"
"vgui_FileCopy_Ovewwrite_Title"	"Fájl(ok) felülírása"
"[english]vgui_FileCopy_Ovewwrite_Title"	"Overwrite file(s)"
"vgui_FileCopy_Ovewwrite_Prompt"	"„%filename%” felülírható?"
"[english]vgui_FileCopy_Ovewwrite_Prompt"	"Overwrite '%filename%'?"
"SMPEvent_AppLaunch"	"Alk. indítása"
"[english]SMPEvent_AppLaunch"	"App Launch"
"SMPEvent_AppExit"	"Alk. bezárása"
"[english]SMPEvent_AppExit"	"App Exit"
"SMPEvent_Close"	"Bezárás"
"[english]SMPEvent_Close"	"Close"
"SMPEvent_FadeOut"	"Elhalványítás"
"[english]SMPEvent_FadeOut"	"Fade Out"
"SMPEvent_MediaBegin"	"Hordozó eleje"
"[english]SMPEvent_MediaBegin"	"Media Begin"
"SMPEvent_MediaEnd"	"Hordozó vége"
"[english]SMPEvent_MediaEnd"	"Media End"
"SMPEvent_Play"	"Lejátszás"
"[english]SMPEvent_Play"	"Play"
"SMPEvent_JumpHome"	"Ugrás az elejére"
"[english]SMPEvent_JumpHome"	"Jump Home"
"SMPEvent_JumpEnd"	"Ugrás a végére"
"[english]SMPEvent_JumpEnd"	"Jump To End"
"SMPEvent_Pause"	"Szünet"
"[english]SMPEvent_Pause"	"Pause"
"SMPEvent_Stop"	"Leállítás"
"[english]SMPEvent_Stop"	"Stop"
"SMPEvent_JumpFrom"	"Áthelyezés innen"
"[english]SMPEvent_JumpFrom"	"Scrub From"
"SMPEvent_JumpTo"	"Áthelyezés ide"
"[english]SMPEvent_JumpTo"	"Scrub To"
"SMPEvent_StepFwd"	"Lépés előre"
"[english]SMPEvent_StepFwd"	"Step Forward"
"SMPEvent_StepBack"	"Lépés vissza"
"[english]SMPEvent_StepBack"	"Step Backwards"
"SMPEvent_JumpFwd"	"Ugrás előre"
"[english]SMPEvent_JumpFwd"	"Jump Forward"
"SMPEvent_JumpBack"	"Ugrás vissza"
"[english]SMPEvent_JumpBack"	"Jump Backwards"
"SMPEvent_Repeat"	"Ismétlés"
"[english]SMPEvent_Repeat"	"Repeat"
"SMPEvent_Maximize"	"Nagy méret"
"[english]SMPEvent_Maximize"	"Maximize"
"SMPEvent_Minimize"	"Kis méret"
"[english]SMPEvent_Minimize"	"Minimize"
"SMPEvent_Restore"	"Visszaállítás"
"[english]SMPEvent_Restore"	"Restore"
"SMPStats_UserId"	"Felhasználó-azonosító:"
"[english]SMPStats_UserId"	"User Id:"
"SMPStats_Filename"	"Fájlnév:"
"[english]SMPStats_Filename"	"Filename:"
"SMPStats_EventTitle"	"Esemény"
"[english]SMPStats_EventTitle"	"Event"
"SMPStats_TimeTitle"	"Idő (ms)"
"[english]SMPStats_TimeTitle"	"Time (ms)"
"SMPStats_PositionTitle"	"Hely (ms)"
"[english]SMPStats_PositionTitle"	"Position (ms)"
"SMPStats_DialogTitle"	"Adatgyűjtési preferenciák"
"[english]SMPStats_DialogTitle"	"Data Collection Preferences"
"SMPStats_DontAskAgain"	"Ne kérdezze meg újra"
"[english]SMPStats_DontAskAgain"	"Don't ask again"
"vgui_Accept"	"Elfogad"
"[english]vgui_Accept"	"Accept"
"vgui_Decline"	"Elutasít"
"[english]vgui_Decline"	"Decline"
"vgui_TimeLeftYearOrMore"	"több mint egy év"
"[english]vgui_TimeLeftYearOrMore"	"more than 1 year"
"vgui_TimeLeftDay"	"%days% nap"
"[english]vgui_TimeLeftDay"	"%days% day"
"vgui_TimeLeftDays"	"%days% nap"
"[english]vgui_TimeLeftDays"	"%days% days"
"vgui_TimeLeftDayRemaining"	"%days% nap maradt"
"[english]vgui_TimeLeftDayRemaining"	"%days% day remaining"
"vgui_TimeLeftDaysRemaining"	"%days% nap maradt"
"[english]vgui_TimeLeftDaysRemaining"	"%days% days remaining"
"vgui_TimeLeftHour"	"%hours% óra"
"[english]vgui_TimeLeftHour"	"%hours% hour"
"vgui_TimeLeftHours"	"%hours% óra"
"[english]vgui_TimeLeftHours"	"%hours% hours"
"vgui_TimeLeftHourRemaining"	"%hours% óra maradt"
"[english]vgui_TimeLeftHourRemaining"	"%hours% hour remaining"
"vgui_TimeLeftHoursRemaining"	"%hours% óra maradt"
"[english]vgui_TimeLeftHoursRemaining"	"%hours% hours remaining"
"vgui_TimeLeftMinute"	"%minutes% perc"
"[english]vgui_TimeLeftMinute"	"%minutes% minute"
"vgui_TimeLeftMinutes"	"%minutes% perc"
"[english]vgui_TimeLeftMinutes"	"%minutes% minutes"
"vgui_TimeLeftMinuteRemaining"	"%minutes% perc maradt"
"[english]vgui_TimeLeftMinuteRemaining"	"%minutes% minute remaining"
"vgui_TimeLeftMinutesRemaining"	"%minutes% perc maradt"
"[english]vgui_TimeLeftMinutesRemaining"	"%minutes% minutes remaining"
"vgui_TimeLeftSecond"	"%seconds% másodperc"
"[english]vgui_TimeLeftSecond"	"%seconds% second"
"vgui_TimeLeftSeconds"	"%seconds% másodperc"
"[english]vgui_TimeLeftSeconds"	"%seconds% seconds"
"vgui_TimeLeftSecondRemaining"	"%seconds% másodperc maradt"
"[english]vgui_TimeLeftSecondRemaining"	"%seconds% second remaining"
"vgui_TimeLeftSecondsRemaining"	"%seconds% másodperc maradt"
"[english]vgui_TimeLeftSecondsRemaining"	"%seconds% seconds remaining"
"vgui_TimeLeftDaysHours"	"%days% nap %hours% óra"
"[english]vgui_TimeLeftDaysHours"	"%days% days %hours% hours"
"vgui_TimeLeftDaysHour"	"%days% nap %hours% óra"
"[english]vgui_TimeLeftDaysHour"	"%days% days %hours% hour"
"vgui_TimeLeftDayHours"	"%days% nap %hours% óra"
"[english]vgui_TimeLeftDayHours"	"%days% day %hours% hours"
"vgui_TimeLeftDayHour"	"%days% nap %hours% óra"
"[english]vgui_TimeLeftDayHour"	"%days% day %hours% hour"
"vgui_TimeLeftDaysHoursRemaining"	"%days% nap %hours% óra maradt"
"[english]vgui_TimeLeftDaysHoursRemaining"	"%days% days %hours% hours remaining"
"vgui_TimeLeftDaysHourRemaining"	"%days% nap %hours% óra maradt"
"[english]vgui_TimeLeftDaysHourRemaining"	"%days% days %hours% hour remaining"
"vgui_TimeLeftDayHoursRemaining"	"%days% nap %hours% óra maradt"
"[english]vgui_TimeLeftDayHoursRemaining"	"%days% day %hours% hours remaining"
"vgui_TimeLeftDayHourRemaining"	"%days% nap %hours% óra maradt"
"[english]vgui_TimeLeftDayHourRemaining"	"%days% day %hours% hour remaining"
"vgui_TimeLeftHoursMinutes"	"%hours% óra %minutes% perc"
"[english]vgui_TimeLeftHoursMinutes"	"%hours% hours %minutes% minutes"
"vgui_TimeLeftHoursMinute"	"%hours% óra %minutes% perc"
"[english]vgui_TimeLeftHoursMinute"	"%hours% hours %minutes% minute"
"vgui_TimeLeftHourMinutes"	"%hours% óra %minutes% perc"
"[english]vgui_TimeLeftHourMinutes"	"%hours% hour %minutes% minutes"
"vgui_TimeLeftHourMinute"	"%hours% óra %minutes% perc"
"[english]vgui_TimeLeftHourMinute"	"%hours% hour %minutes% minute"
"vgui_TimeLeftHoursMinutesRemaining"	"%hours% óra %minutes% perc maradt"
"[english]vgui_TimeLeftHoursMinutesRemaining"	"%hours% hours %minutes% minutes remaining"
"vgui_TimeLeftHoursMinuteRemaining"	"%hours% óra %minutes% perc maradt"
"[english]vgui_TimeLeftHoursMinuteRemaining"	"%hours% hours %minutes% minute remaining"
"vgui_TimeLeftHourMinutesRemaining"	"%hours% óra %minutes% perc maradt"
"[english]vgui_TimeLeftHourMinutesRemaining"	"%hours% hour %minutes% minutes remaining"
"vgui_TimeLeftHourMinuteRemaining"	"%hours% óra %minutes% perc maradt"
"[english]vgui_TimeLeftHourMinuteRemaining"	"%hours% hour %minutes% minute remaining"
"vgui_TimeLeftMinutesSeconds"	"%minutes% perc %seconds% másodperc"
"[english]vgui_TimeLeftMinutesSeconds"	"%minutes% minutes %seconds% seconds"
"vgui_TimeLeftMinutesSecond"	"%minutes% perc %seconds% másodperc"
"[english]vgui_TimeLeftMinutesSecond"	"%minutes% minutes %seconds% second"
"vgui_TimeLeftMinuteSeconds"	"%minutes% perc %seconds% másodperc"
"[english]vgui_TimeLeftMinuteSeconds"	"%minutes% minute %seconds% seconds"
"vgui_TimeLeftMinuteSecond"	"%minutes% perc %seconds% másodperc"
"[english]vgui_TimeLeftMinuteSecond"	"%minutes% minute %seconds% second"
"vgui_TimeLeftMinutesSecondsRemaining"	"%minutes% perc %seconds% másodperc maradt"
"[english]vgui_TimeLeftMinutesSecondsRemaining"	"%minutes% minutes %seconds% seconds remaining"
"vgui_TimeLeftMinutesSecondRemaining"	"%minutes% perc %seconds% másodperc maradt"
"[english]vgui_TimeLeftMinutesSecondRemaining"	"%minutes% minutes %seconds% second remaining"
"vgui_TimeLeftMinuteSecondsRemaining"	"%minutes% perc %seconds% másodperc maradt"
"[english]vgui_TimeLeftMinuteSecondsRemaining"	"%minutes% minute %seconds% seconds remaining"
"vgui_TimeLeftMinuteSecondRemaining"	"%minutes% perc %seconds% másodperc maradt"
"[english]vgui_TimeLeftMinuteSecondRemaining"	"%minutes% minute %seconds% second remaining"
"vgui_Today"	"Ma"
"[english]vgui_Today"	"Today"
"vgui_Yesterday"	"Tegnap"
"[english]vgui_Yesterday"	"Yesterday"
"vgui_Tomorrow"	"Holnap"
"[english]vgui_Tomorrow"	"Tomorrow"
"vgui_OnForDays"	"Bekapcsolva %days% napja"
"[english]vgui_OnForDays"	"On for %days% days"
"vgui_OnForHours"	"Bekapcsolva %hours% órája"
"[english]vgui_OnForHours"	"On for %hours% hours"
"vgui_OnForMinutes"	"Bekapcsolva %minutes% perce"
"[english]vgui_OnForMinutes"	"On for %minutes% minutes"
"vgui_OnForSeconds"	"Bekapcsolva %seconds% másodperce"
"[english]vgui_OnForSeconds"	"On for %seconds% seconds"
"vgui_OnForDay"	"Bekapcsolva %days% napja"
"[english]vgui_OnForDay"	"On for %days% day"
"vgui_OnForHour"	"Bekapcsolva %hours% órája"
"[english]vgui_OnForHour"	"On for %hours% hour"
"vgui_OnForMinute"	"Bekapcsolva %minutes% perce"
"[english]vgui_OnForMinute"	"On for %minutes% minute"
"vgui_OnForSecond"	"Bekapcsolva %seconds% másodperce"
"[english]vgui_OnForSecond"	"On for %seconds% second"
"vgui_LastOnYearOrMore"	"Legutóbb online: több mint egy éve"
"[english]vgui_LastOnYearOrMore"	"Last Online: more than 1 year ago"
"vgui_LastOnDays"	"Legutóbb online: %days% napja"
"[english]vgui_LastOnDays"	"Last Online: %days% days ago"
"vgui_LastOnHours"	"Legutóbb online: %hours% órája"
"[english]vgui_LastOnHours"	"Last Online: %hours% hours ago"
"vgui_LastOnMinutes"	"Legutóbb online: %minutes% perce"
"[english]vgui_LastOnMinutes"	"Last Online: %minutes% minutes ago"
"vgui_LastOnSeconds"	"Legutóbb online: %seconds% másodperce"
"[english]vgui_LastOnSeconds"	"Last Online: %seconds% seconds ago"
"vgui_LastOnDay"	"Legutóbb online: %days% napja"
"[english]vgui_LastOnDay"	"Last Online: %days% day ago"
"vgui_LastOnHour"	"Legutóbb online: %hours% órája"
"[english]vgui_LastOnHour"	"Last Online: %hours% hour ago"
"vgui_LastOnMinute"	"Legutóbb online: %minutes% perce"
"[english]vgui_LastOnMinute"	"Last Online: %minutes% minute ago"
"vgui_LastOnSecond"	"Legutóbb online: %seconds% másodperce"
"[english]vgui_LastOnSecond"	"Last Online: %seconds% second ago"
"vgui_TimeAgoYearOrMore"	"több mint egy éve"
"[english]vgui_TimeAgoYearOrMore"	"more than 1 year ago"
"vgui_TimeAgoDays"	"%days% napja"
"[english]vgui_TimeAgoDays"	"%days% days ago"
"vgui_TimeAgoHours"	"%hours% órája"
"[english]vgui_TimeAgoHours"	"%hours% hours ago"
"vgui_TimeAgoMinutes"	"%minutes% perce"
"[english]vgui_TimeAgoMinutes"	"%minutes% minutes ago"
"vgui_TimeAgoSeconds"	"%seconds% másodperce"
"[english]vgui_TimeAgoSeconds"	"%seconds% seconds ago"
"vgui_TimeAgoDay"	"%days% napja"
"[english]vgui_TimeAgoDay"	"%days% day ago"
"vgui_TimeAgoHour"	"%hours% órája"
"[english]vgui_TimeAgoHour"	"%hours% hour ago"
"vgui_TimeAgoMinute"	"%minutes% perce"
"[english]vgui_TimeAgoMinute"	"%minutes% minute ago"
"vgui_TimeAgoSecond"	"%seconds% másodperce"
"[english]vgui_TimeAgoSecond"	"%seconds% second ago"
"FileOpenDialog_Col_Name"	"Név"
"[english]FileOpenDialog_Col_Name"	"Name"
"FileOpenDialog_Col_Size"	"Méret"
"[english]FileOpenDialog_Col_Size"	"Size"
"FileOpenDialog_Col_Type"	"Típus"
"[english]FileOpenDialog_Col_Type"	"Type"
"FileOpenDialog_Col_DateModified"	"Módosítás dátuma"
"[english]FileOpenDialog_Col_DateModified"	"Date Modified"
"FileOpenDialog_Col_DateCreated"	"Létrehozás dátuma"
"[english]FileOpenDialog_Col_DateCreated"	"Date Created"
"FileOpenDialog_Col_Attributes"	"Attribútumok"
"[english]FileOpenDialog_Col_Attributes"	"Attributes"
"FileOpenDialog_FileType_Folder"	"Fájlmappa"
"[english]FileOpenDialog_FileType_Folder"	"File Folder"
"FileOpenDialog_ToolTip_Up"	"Fel"
"[english]FileOpenDialog_ToolTip_Up"	"Up"
"FileOpenDialog_ToolTip_NewFolder"	"Új mappa"
"[english]FileOpenDialog_ToolTip_NewFolder"	"New Folder"
"FileOpenDialog_NewFolder_InputTitle"	"Új mappa"
"[english]FileOpenDialog_NewFolder_InputTitle"	"New Folder"
"FileOpenDialog_NewFolderPrompt"	"Név:"
"[english]FileOpenDialog_NewFolderPrompt"	"Name:"
"FileOpenDialog_NewFolder_DefaultName"	"Új mappa"
"[english]FileOpenDialog_NewFolder_DefaultName"	"New Folder"
"vgui_Webkit_error_title"	"Hiba"
"[english]vgui_Webkit_error_title"	"Error"
"vgui_Webkit_pagetypeunsupported"	"Oldal nem betölthető; nem támogatott oldalformátum"
"[english]vgui_Webkit_pagetypeunsupported"	"Unable to load page, unsupported page format"
"vgui_Webkit_cachemiss"	"Az űrlapkérelem elavult. Az űrlapadatok újraküldéséhez kattints az újratöltésre."
"[english]vgui_Webkit_cachemiss"	"Your form request has expired. Click reload to re-submit the form data."
"vgui_Webkit_badurl"	"URL nem betölthető; hibás gépnév vagy formátum"
"[english]vgui_Webkit_badurl"	"Unable to load URL, bad hostname or format"
"vgui_Webkit_connectionproblem"	"Nem lehet csatlakozni a szerverhez. Lehet, hogy nem üzemel, vagy nem kapcsolódsz az internethez."
"[english]vgui_Webkit_connectionproblem"	"Unable to connect to server. Server may be offline or you may not be connected to the internet."
"vgui_Webkit_unknown"	"Weboldal betöltése sikertelen (ismeretlen hiba)."
"[english]vgui_Webkit_unknown"	"Failed to load web page (unknown error)."
"vgui_HTMLBack"	"Vissza"
"[english]vgui_HTMLBack"	"Back"
"vgui_HTMLForward"	"Előre"
"[english]vgui_HTMLForward"	"Forward"
"vgui_HTMLReload"	"Újratöltés"
"[english]vgui_HTMLReload"	"Reload"
"vgui_HTMLStop"	"Leállítás"
"[english]vgui_HTMLStop"	"Stop"
"vgui_HTMLViewSource"	"Forrás megnézése..."
"[english]vgui_HTMLViewSource"	"View Source..."
"vgui_Webkit_error_header"	"Hibakód:"
"[english]vgui_Webkit_error_header"	"Error Code: "
"vgui_Webkit_proxyconnectionproblem"	"Nem lehet csatlakozni a HTTP proxyhoz. Lehet, hogy a proxyd rosszul van beállítva, vagy nem üzemel."
"[english]vgui_Webkit_proxyconnectionproblem"	"Unable to connect to HTTP Proxy. Your proxy may be misconfigured or offline."
"vgui_HTMLCopyUrl"	"Oldal URL-jének másolása"
"[english]vgui_HTMLCopyUrl"	"Copy Page URL"
"vgui_HTMLCopyLink"	"Hivatkozás címének másolása"
"[english]vgui_HTMLCopyLink"	"Copy Link Address"
"vgui_HTMLSearchMatch"	"%findactive% / %findcount%"
"[english]vgui_HTMLSearchMatch"	"%findactive% of %findcount%"
"vgui_HTMLSearchThisPage"	"Keresés a lapon"
"[english]vgui_HTMLSearchThisPage"	"Search this page"
"vgui_choosedirectoryname"	"Válassz könyvtárnevet"
"[english]vgui_choosedirectoryname"	"Choose directory name"
"TextEntry_CopyAllToClipboard"	"Minden szöveg másolása a vágólapra"
"[english]TextEntry_CopyAllToClipboard"	"Copy all text to clipboard"
"vgui_yes"	"Igen"
"[english]vgui_yes"	"Yes"
"vgui_no"	"Nem"
"[english]vgui_no"	"No"
"vgui_HTMLCloseDevTools"	"Fejlesztői eszközök bezárása"
"[english]vgui_HTMLCloseDevTools"	"Close Developer Tools"
"vgui_HTMLOpenDevTools"	"Fejlesztői eszközök megnyitása"
"[english]vgui_HTMLOpenDevTools"	"Open Developer Tools"
"vgui_continue"	"Tovább"
"[english]vgui_continue"	"Continue"
"vgui_ShuttingDown"	"Kilépés..."
"[english]vgui_ShuttingDown"	"Shutting down..."
"vgui_HTMLInspectElement"	"Elem vizsgálata"
"[english]vgui_HTMLInspectElement"	"Inspect Element"
}
}
