"lang"
{
"Language"	"russian"
"Tokens"
{
"TextEntry_Cut"	"Вырезать"
"[english]TextEntry_Cut"	"Cut"
"TextEntry_Copy"	"Скопировать"
"[english]TextEntry_Copy"	"Copy"
"TextEntry_Paste"	"Вставить"
"[english]TextEntry_Paste"	"Paste"
"TextEntry_SelectAll"	"Выделить всё"
"[english]TextEntry_SelectAll"	"Select all"
"FileOpenDialog_Open"	"Открыть"
"[english]FileOpenDialog_Open"	"Open"
"FileOpenDialog_Cancel"	"Отмена"
"[english]FileOpenDialog_Cancel"	"Cancel"
"FileOpenDialog_Look_in"	"Искать в:"
"[english]FileOpenDialog_Look_in"	"Look in:"
"FileOpenDialog_File_Name"	"Имя файла:"
"[english]FileOpenDialog_File_Name"	"File name:"
"FileOpenDialog_File_Type"	"Тип файла:"
"[english]FileOpenDialog_File_Type"	"File type:"
"FileOpenDialog_Icon"	" "
"[english]FileOpenDialog_Icon"	" "
"FileOpenDialog_Name"	"Имя"
"[english]FileOpenDialog_Name"	"Name"
"FileOpenDialog_Type"	"Тип"
"[english]FileOpenDialog_Type"	"Type"
"SysMenu_Minimize"	" Свернуть "
"[english]SysMenu_Minimize"	" Minimize "
"SysMenu_Maximize"	" Развернуть "
"[english]SysMenu_Maximize"	" Maximize "
"SysMenu_Close"	" Закрыть "
"[english]SysMenu_Close"	" Close "
"Frame_Untitled"	"Без названия"
"[english]Frame_Untitled"	"Untitled"
"MessageBox_OK"	"OK"
"[english]MessageBox_OK"	"OK"
"PropertyDialog_OK"	"OK"
"[english]PropertyDialog_OK"	"OK"
"PropertyDialog_Cancel"	"Отмена"
"[english]PropertyDialog_Cancel"	"Cancel"
"PropertyDialog_Apply"	"Применить"
"[english]PropertyDialog_Apply"	"Apply"
"QueryBox_Cancel"	"Отмена"
"[english]QueryBox_Cancel"	"Cancel"
"WizardPanel_Next"	"Далее >"
"[english]WizardPanel_Next"	"Next >"
"WizardPanel_Back"	"< Назад"
"[english]WizardPanel_Back"	"< Back"
"WizardPanel_Finish"	"Готово"
"[english]WizardPanel_Finish"	"Finish"
"WizardPanel_Cancel"	"Отмена"
"[english]WizardPanel_Cancel"	"Cancel"
"vgui_ok"	"OK"
"[english]vgui_ok"	"OK"
"vgui_close"	"Закрыть"
"[english]vgui_close"	"Close"
"vgui_Cancel"	"Отмена"
"[english]vgui_Cancel"	"Cancel"
"vgui_select"	"Выбрать"
"[english]vgui_select"	"Select"
"vgui_createfolder"	"Создать папку…"
"[english]vgui_createfolder"	"New Folder..."
"vgui_next"	"Далее >"
"[english]vgui_next"	"Next >"
"vgui_back"	"< Назад"
"[english]vgui_back"	"< Back"
"vgui_CreateDirectoryFail_Title"	"Создать папку — Ошибка"
"[english]vgui_CreateDirectoryFail_Title"	"Create Folder - Error"
"vgui_CreateDirectoryFail_Info"	"Не удалось создать папку — данный диск недоступен для записи."
"[english]vgui_CreateDirectoryFail_Info"	"Failed to create a folder, this drive is read-only."
"vgui_CreateDirectoryFail_AlreadyExists"	"Эта папка уже существует."
"[english]vgui_CreateDirectoryFail_AlreadyExists"	"That folder already exists."
"TextEntry_Language"	"Язык"
"[english]TextEntry_Language"	"Language"
"TextEntry_ConversionMode"	"Режим преобразования"
"[english]TextEntry_ConversionMode"	"Conversion Mode"
"TextEntry_SentenceMode"	"Режим предложения"
"[english]TextEntry_SentenceMode"	"Sentence Mode"
"IME_English"	"Английский"
"[english]IME_English"	"English"
"IME_Chinese"	"Китайский"
"[english]IME_Chinese"	"Chinese"
"IME_Korean"	"Корейский"
"[english]IME_Korean"	"Korean"
"IME_Hiragana"	"Хирагана"
"[english]IME_Hiragana"	"Hiragana"
"IME_FullWidthKatakana"	"Катакана, полноширинный шрифт"
"[english]IME_FullWidthKatakana"	"Full-width Katakana"
"IME_FullWidthAlphanumeric"	"Буквенно-цифровой полной ширины"
"[english]IME_FullWidthAlphanumeric"	"Full-width Alphanumeric"
"IME_HalfWidthKatakana"	"Катакана в половину ширины"
"[english]IME_HalfWidthKatakana"	"Half-width Katakana"
"IME_HalfWidthAlphanumeric"	"Буквенно-цифровой половинной ширины"
"[english]IME_HalfWidthAlphanumeric"	"Half-width Alphanumeric"
"IME_General"	"Общий"
"[english]IME_General"	"General"
"IME_BiasNames"	"Предпочтение названий"
"[english]IME_BiasNames"	"Bias for Names"
"IME_BiasSpeech"	"Предпочтение речи"
"[english]IME_BiasSpeech"	"Bias for Speech"
"IME_NoConversion"	"Без перевода"
"[english]IME_NoConversion"	"No Conversion"
"IME_0404"	"Китайский (Тайвань)"
"[english]IME_0404"	"Chinese (Taiwan)"
"IME_0804"	"Китайский (КНР)"
"[english]IME_0804"	"Chinese (PRC)"
"IME_0409"	"Английский (США)"
"[english]IME_0409"	"English (United States)"
"IME_0411"	"Японский"
"[english]IME_0411"	"Japanese"
"IME_0412"	"Корейский"
"[english]IME_0412"	"Korean"
"IME_0419"	"Русский"
"[english]IME_0419"	"Russian"
"IME_041e"	"Тайский"
"[english]IME_041e"	"Thai"
"IME_040c"	"Французский (стандартный)"
"[english]IME_040c"	"French (Standard)"
"IME_0407"	"Немецкий (стандартный)"
"[english]IME_0407"	"German (Standard)"
"IME_0410"	"Итальянский (стандартный)"
"[english]IME_0410"	"Italian (Standard)"
"IME_040a"	"Испанский (Испания, традиц. сорт.)"
"[english]IME_040a"	"Spanish (Spain, Traditional Sort)"
"vgui_FileCopyDialog_Title"	"Копирование..."
"[english]vgui_FileCopyDialog_Title"	"Copying..."
"vgui_FileMoveDialog_Title"	"Перемещение…"
"[english]vgui_FileMoveDialog_Title"	"Moving..."
"vgui_FileCopy_Estimate"	"Осталось %s1"
"[english]vgui_FileCopy_Estimate"	"%s1 remaining"
"vgui_FileCopy_Copying_Multiple"	"Копирую '%s1' (осталось %s2)"
"[english]vgui_FileCopy_Copying_Multiple"	"Copying '%s1' (%s2 remaining)"
"vgui_FileCopy_Copying_Single"	"Копирую '%s1'"
"[english]vgui_FileCopy_Copying_Single"	"Copying '%s1'"
"vgui_FileCopy_Ovewwrite_Title"	"Записать поверх файла(ов)"
"[english]vgui_FileCopy_Ovewwrite_Title"	"Overwrite file(s)"
"vgui_FileCopy_Ovewwrite_Prompt"	"Записать поверх '%filename%'?"
"[english]vgui_FileCopy_Ovewwrite_Prompt"	"Overwrite '%filename%'?"
"SMPEvent_AppLaunch"	"Запуск приложения"
"[english]SMPEvent_AppLaunch"	"App Launch"
"SMPEvent_AppExit"	"Выход из приложения"
"[english]SMPEvent_AppExit"	"App Exit"
"SMPEvent_Close"	"Закрыть"
"[english]SMPEvent_Close"	"Close"
"SMPEvent_FadeOut"	"Затухание"
"[english]SMPEvent_FadeOut"	"Fade Out"
"SMPEvent_MediaBegin"	"Начало медиа"
"[english]SMPEvent_MediaBegin"	"Media Begin"
"SMPEvent_MediaEnd"	"Окончание медиа"
"[english]SMPEvent_MediaEnd"	"Media End"
"SMPEvent_Play"	"Запустить"
"[english]SMPEvent_Play"	"Play"
"SMPEvent_JumpHome"	"Перейти в начало"
"[english]SMPEvent_JumpHome"	"Jump Home"
"SMPEvent_JumpEnd"	"Перейти в конец"
"[english]SMPEvent_JumpEnd"	"Jump To End"
"SMPEvent_Pause"	"Приостановить"
"[english]SMPEvent_Pause"	"Pause"
"SMPEvent_Stop"	"Стоп"
"[english]SMPEvent_Stop"	"Stop"
"SMPEvent_JumpFrom"	"Воспроизвести от"
"[english]SMPEvent_JumpFrom"	"Scrub From"
"SMPEvent_JumpTo"	"Воспроизвести до"
"[english]SMPEvent_JumpTo"	"Scrub To"
"SMPEvent_StepFwd"	"Шаг вперед"
"[english]SMPEvent_StepFwd"	"Step Forward"
"SMPEvent_StepBack"	"Шаг назад"
"[english]SMPEvent_StepBack"	"Step Backwards"
"SMPEvent_JumpFwd"	"Перейти вперед"
"[english]SMPEvent_JumpFwd"	"Jump Forward"
"SMPEvent_JumpBack"	"Перейти назад"
"[english]SMPEvent_JumpBack"	"Jump Backwards"
"SMPEvent_Repeat"	"Повторить"
"[english]SMPEvent_Repeat"	"Repeat"
"SMPEvent_Maximize"	"Развернуть"
"[english]SMPEvent_Maximize"	"Maximize"
"SMPEvent_Minimize"	"Свернуть"
"[english]SMPEvent_Minimize"	"Minimize"
"SMPEvent_Restore"	"Восстановить"
"[english]SMPEvent_Restore"	"Restore"
"SMPStats_UserId"	"ID пользователя:"
"[english]SMPStats_UserId"	"User Id:"
"SMPStats_Filename"	"Имя файла:"
"[english]SMPStats_Filename"	"Filename:"
"SMPStats_EventTitle"	"Событие"
"[english]SMPStats_EventTitle"	"Event"
"SMPStats_TimeTitle"	"Время (мс)"
"[english]SMPStats_TimeTitle"	"Time (ms)"
"SMPStats_PositionTitle"	"Позиция (мс)"
"[english]SMPStats_PositionTitle"	"Position (ms)"
"SMPStats_DialogTitle"	"Параметры сбора данных"
"[english]SMPStats_DialogTitle"	"Data Collection Preferences"
"SMPStats_DontAskAgain"	"Больше не спрашивать"
"[english]SMPStats_DontAskAgain"	"Don't ask again"
"vgui_Accept"	"Принять"
"[english]vgui_Accept"	"Accept"
"vgui_Decline"	"Отклонить"
"[english]vgui_Decline"	"Decline"
"vgui_TimeLeftYearOrMore"	"свыше года"
"[english]vgui_TimeLeftYearOrMore"	"more than 1 year"
"vgui_TimeLeftDay"	"%days% день"
"[english]vgui_TimeLeftDay"	"%days% day"
"vgui_TimeLeftDays"	"%days% дн."
"[english]vgui_TimeLeftDays"	"%days% days"
"vgui_TimeLeftDayRemaining"	"Осталось дней: %days%"
"[english]vgui_TimeLeftDayRemaining"	"%days% day remaining"
"vgui_TimeLeftDaysRemaining"	"Осталось дней: %days%"
"[english]vgui_TimeLeftDaysRemaining"	"%days% days remaining"
"vgui_TimeLeftHour"	"%hours% час"
"[english]vgui_TimeLeftHour"	"%hours% hour"
"vgui_TimeLeftHours"	"%hours% ч."
"[english]vgui_TimeLeftHours"	"%hours% hours"
"vgui_TimeLeftHourRemaining"	"Остался %hours% час"
"[english]vgui_TimeLeftHourRemaining"	"%hours% hour remaining"
"vgui_TimeLeftHoursRemaining"	"Осталось %hours% ч."
"[english]vgui_TimeLeftHoursRemaining"	"%hours% hours remaining"
"vgui_TimeLeftMinute"	"%minutes% минута"
"[english]vgui_TimeLeftMinute"	"%minutes% minute"
"vgui_TimeLeftMinutes"	"%minutes% мин."
"[english]vgui_TimeLeftMinutes"	"%minutes% minutes"
"vgui_TimeLeftMinuteRemaining"	"Осталась %minutes% минута"
"[english]vgui_TimeLeftMinuteRemaining"	"%minutes% minute remaining"
"vgui_TimeLeftMinutesRemaining"	"Осталось %minutes% мин."
"[english]vgui_TimeLeftMinutesRemaining"	"%minutes% minutes remaining"
"vgui_TimeLeftSecond"	"%seconds% сек"
"[english]vgui_TimeLeftSecond"	"%seconds% second"
"vgui_TimeLeftSeconds"	"%seconds% сек"
"[english]vgui_TimeLeftSeconds"	"%seconds% seconds"
"vgui_TimeLeftSecondRemaining"	"Осталась%seconds% сек"
"[english]vgui_TimeLeftSecondRemaining"	"%seconds% second remaining"
"vgui_TimeLeftSecondsRemaining"	"Осталось%seconds% сек"
"[english]vgui_TimeLeftSecondsRemaining"	"%seconds% seconds remaining"
"vgui_TimeLeftDaysHours"	"%days% дн. %hours% ч."
"[english]vgui_TimeLeftDaysHours"	"%days% days %hours% hours"
"vgui_TimeLeftDaysHour"	"%days% дн. %hours% ч."
"[english]vgui_TimeLeftDaysHour"	"%days% days %hours% hour"
"vgui_TimeLeftDayHours"	"%days% день %hours% ч."
"[english]vgui_TimeLeftDayHours"	"%days% day %hours% hours"
"vgui_TimeLeftDayHour"	"%days% день %hours% час"
"[english]vgui_TimeLeftDayHour"	"%days% day %hours% hour"
"vgui_TimeLeftDaysHoursRemaining"	"Осталось %days% дн. %hours% ч."
"[english]vgui_TimeLeftDaysHoursRemaining"	"%days% days %hours% hours remaining"
"vgui_TimeLeftDaysHourRemaining"	"Осталось %days% дн. %hours% час"
"[english]vgui_TimeLeftDaysHourRemaining"	"%days% days %hours% hour remaining"
"vgui_TimeLeftDayHoursRemaining"	"Остался %days% день %hours% ч."
"[english]vgui_TimeLeftDayHoursRemaining"	"%days% day %hours% hours remaining"
"vgui_TimeLeftDayHourRemaining"	"Остался %days% день %hours% час"
"[english]vgui_TimeLeftDayHourRemaining"	"%days% day %hours% hour remaining"
"vgui_TimeLeftHoursMinutes"	"%hours% ч. %minutes% мин."
"[english]vgui_TimeLeftHoursMinutes"	"%hours% hours %minutes% minutes"
"vgui_TimeLeftHoursMinute"	"%hours% ч. %minutes% минута"
"[english]vgui_TimeLeftHoursMinute"	"%hours% hours %minutes% minute"
"vgui_TimeLeftHourMinutes"	"%hours% час %minutes% мин."
"[english]vgui_TimeLeftHourMinutes"	"%hours% hour %minutes% minutes"
"vgui_TimeLeftHourMinute"	"%hours% час %minutes% минута"
"[english]vgui_TimeLeftHourMinute"	"%hours% hour %minutes% minute"
"vgui_TimeLeftHoursMinutesRemaining"	"Осталось %hours% ч. %minutes% мин."
"[english]vgui_TimeLeftHoursMinutesRemaining"	"%hours% hours %minutes% minutes remaining"
"vgui_TimeLeftHoursMinuteRemaining"	"Осталось %hours% ч. %minutes% минута"
"[english]vgui_TimeLeftHoursMinuteRemaining"	"%hours% hours %minutes% minute remaining"
"vgui_TimeLeftHourMinutesRemaining"	"Остался %hours% час %minutes% мин."
"[english]vgui_TimeLeftHourMinutesRemaining"	"%hours% hour %minutes% minutes remaining"
"vgui_TimeLeftHourMinuteRemaining"	"Осталось %hours% ч. %minutes% минута"
"[english]vgui_TimeLeftHourMinuteRemaining"	"%hours% hour %minutes% minute remaining"
"vgui_TimeLeftMinutesSeconds"	"%minutes% мин. %seconds% сек."
"[english]vgui_TimeLeftMinutesSeconds"	"%minutes% minutes %seconds% seconds"
"vgui_TimeLeftMinutesSecond"	"%minutes% мин. %seconds% сек."
"[english]vgui_TimeLeftMinutesSecond"	"%minutes% minutes %seconds% second"
"vgui_TimeLeftMinuteSeconds"	"%minutes% мин. %seconds% сек."
"[english]vgui_TimeLeftMinuteSeconds"	"%minutes% minute %seconds% seconds"
"vgui_TimeLeftMinuteSecond"	"%minutes% мин. %seconds% сек."
"[english]vgui_TimeLeftMinuteSecond"	"%minutes% minute %seconds% second"
"vgui_TimeLeftMinutesSecondsRemaining"	"Осталось %minutes% мин. %seconds% сек."
"[english]vgui_TimeLeftMinutesSecondsRemaining"	"%minutes% minutes %seconds% seconds remaining"
"vgui_TimeLeftMinutesSecondRemaining"	"Осталось %minutes% мин. %seconds% секунда"
"[english]vgui_TimeLeftMinutesSecondRemaining"	"%minutes% minutes %seconds% second remaining"
"vgui_TimeLeftMinuteSecondsRemaining"	"Осталась %minutes% минута %seconds% сек."
"[english]vgui_TimeLeftMinuteSecondsRemaining"	"%minutes% minute %seconds% seconds remaining"
"vgui_TimeLeftMinuteSecondRemaining"	"Осталась %minutes% минута %seconds% секунда"
"[english]vgui_TimeLeftMinuteSecondRemaining"	"%minutes% minute %seconds% second remaining"
"vgui_Today"	"Сегодня"
"[english]vgui_Today"	"Today"
"vgui_Yesterday"	"Вчера"
"[english]vgui_Yesterday"	"Yesterday"
"vgui_Tomorrow"	"Завтра"
"[english]vgui_Tomorrow"	"Tomorrow"
"vgui_OnForDays"	"В сети на протяжении %days% дн."
"[english]vgui_OnForDays"	"On for %days% days"
"vgui_OnForHours"	"В сети на протяжении %hours% ч."
"[english]vgui_OnForHours"	"On for %hours% hours"
"vgui_OnForMinutes"	"В сети на протяжении %minutes% мин."
"[english]vgui_OnForMinutes"	"On for %minutes% minutes"
"vgui_OnForSeconds"	"В сети на протяжении %seconds% сек."
"[english]vgui_OnForSeconds"	"On for %seconds% seconds"
"vgui_OnForDay"	"В сети на протяжении %days% дня"
"[english]vgui_OnForDay"	"On for %days% day"
"vgui_OnForHour"	"В сети на протяжении %hours% часа"
"[english]vgui_OnForHour"	"On for %hours% hour"
"vgui_OnForMinute"	"В сети на протяжении %minutes% минуты"
"[english]vgui_OnForMinute"	"On for %minutes% minute"
"vgui_OnForSecond"	"В сети на протяжении %seconds% сек."
"[english]vgui_OnForSecond"	"On for %seconds% second"
"vgui_LastOnYearOrMore"	"В сети: более года назад"
"[english]vgui_LastOnYearOrMore"	"Last Online: more than 1 year ago"
"vgui_LastOnDays"	"В сети: %days% дн. назад"
"[english]vgui_LastOnDays"	"Last Online: %days% days ago"
"vgui_LastOnHours"	"В сети: %hours% ч. назад"
"[english]vgui_LastOnHours"	"Last Online: %hours% hours ago"
"vgui_LastOnMinutes"	"В сети: %minutes% мин. назад"
"[english]vgui_LastOnMinutes"	"Last Online: %minutes% minutes ago"
"vgui_LastOnSeconds"	"В сети: %seconds% сек. назад"
"[english]vgui_LastOnSeconds"	"Last Online: %seconds% seconds ago"
"vgui_LastOnDay"	"В сети: %days% день назад"
"[english]vgui_LastOnDay"	"Last Online: %days% day ago"
"vgui_LastOnHour"	"В сети: %hours% час назад"
"[english]vgui_LastOnHour"	"Last Online: %hours% hour ago"
"vgui_LastOnMinute"	"В сети: %minutes% минуту назад"
"[english]vgui_LastOnMinute"	"Last Online: %minutes% minute ago"
"vgui_LastOnSecond"	"В сети: %seconds% сек. назад"
"[english]vgui_LastOnSecond"	"Last Online: %seconds% second ago"
"vgui_TimeAgoYearOrMore"	"свыше года"
"[english]vgui_TimeAgoYearOrMore"	"more than 1 year ago"
"vgui_TimeAgoDays"	"%days% дн. назад"
"[english]vgui_TimeAgoDays"	"%days% days ago"
"vgui_TimeAgoHours"	"%hours% ч. назад"
"[english]vgui_TimeAgoHours"	"%hours% hours ago"
"vgui_TimeAgoMinutes"	"%minutes% мин. назад"
"[english]vgui_TimeAgoMinutes"	"%minutes% minutes ago"
"vgui_TimeAgoSeconds"	"%seconds% сек. назад"
"[english]vgui_TimeAgoSeconds"	"%seconds% seconds ago"
"vgui_TimeAgoDay"	"%days% день назад"
"[english]vgui_TimeAgoDay"	"%days% day ago"
"vgui_TimeAgoHour"	"%hours% час назад"
"[english]vgui_TimeAgoHour"	"%hours% hour ago"
"vgui_TimeAgoMinute"	"%minutes% минуту назад"
"[english]vgui_TimeAgoMinute"	"%minutes% minute ago"
"vgui_TimeAgoSecond"	"%seconds% сек. назад"
"[english]vgui_TimeAgoSecond"	"%seconds% second ago"
"FileOpenDialog_Col_Name"	"Имя"
"[english]FileOpenDialog_Col_Name"	"Name"
"FileOpenDialog_Col_Size"	"Размер"
"[english]FileOpenDialog_Col_Size"	"Size"
"FileOpenDialog_Col_Type"	"Тип"
"[english]FileOpenDialog_Col_Type"	"Type"
"FileOpenDialog_Col_DateModified"	"Дата изменения"
"[english]FileOpenDialog_Col_DateModified"	"Date Modified"
"FileOpenDialog_Col_DateCreated"	"Дата создания"
"[english]FileOpenDialog_Col_DateCreated"	"Date Created"
"FileOpenDialog_Col_Attributes"	"Атрибуты"
"[english]FileOpenDialog_Col_Attributes"	"Attributes"
"FileOpenDialog_FileType_Folder"	"Папка с файлами"
"[english]FileOpenDialog_FileType_Folder"	"File Folder"
"FileOpenDialog_ToolTip_Up"	"Вверх"
"[english]FileOpenDialog_ToolTip_Up"	"Up"
"FileOpenDialog_ToolTip_NewFolder"	"Новая папка"
"[english]FileOpenDialog_ToolTip_NewFolder"	"New Folder"
"FileOpenDialog_NewFolder_InputTitle"	"Новая папка"
"[english]FileOpenDialog_NewFolder_InputTitle"	"New Folder"
"FileOpenDialog_NewFolderPrompt"	"Имя:"
"[english]FileOpenDialog_NewFolderPrompt"	"Name:"
"FileOpenDialog_NewFolder_DefaultName"	"Новая папка"
"[english]FileOpenDialog_NewFolder_DefaultName"	"New Folder"
"vgui_Webkit_error_title"	"Ошибка"
"[english]vgui_Webkit_error_title"	"Error"
"vgui_Webkit_pagetypeunsupported"	"Невозможно загрузить страницу, формат страницы не поддерживается"
"[english]vgui_Webkit_pagetypeunsupported"	"Unable to load page, unsupported page format"
"vgui_Webkit_cachemiss"	"Время действия вашего запроса данных формы истекло. Щелкните \"Обновить\", чтобы заново отправить данные формы."
"[english]vgui_Webkit_cachemiss"	"Your form request has expired. Click reload to re-submit the form data."
"vgui_Webkit_badurl"	"Невозможно загрузить URL, неправильное имя или формат"
"[english]vgui_Webkit_badurl"	"Unable to load URL, bad hostname or format"
"vgui_Webkit_connectionproblem"	"Не удаётся соединиться с сервером. Возможно, сервер отключён, или вы не подключены к интернету."
"[english]vgui_Webkit_connectionproblem"	"Unable to connect to server. Server may be offline or you may not be connected to the internet."
"vgui_Webkit_unknown"	"Не удалось загрузить веб-страницу (неизвестная ошибка)."
"[english]vgui_Webkit_unknown"	"Failed to load web page (unknown error)."
"vgui_HTMLBack"	"Назад"
"[english]vgui_HTMLBack"	"Back"
"vgui_HTMLForward"	"Вперед"
"[english]vgui_HTMLForward"	"Forward"
"vgui_HTMLReload"	"Обновить"
"[english]vgui_HTMLReload"	"Reload"
"vgui_HTMLStop"	"Остановить"
"[english]vgui_HTMLStop"	"Stop"
"vgui_HTMLViewSource"	"Просмотреть исходный код…"
"[english]vgui_HTMLViewSource"	"View Source..."
"vgui_Webkit_error_header"	"Код ошибки:"
"[english]vgui_Webkit_error_header"	"Error Code: "
"vgui_Webkit_proxyconnectionproblem"	"Не удается подключиться к прокси-серверу. Возможно, вы указали неверные данные прокси-сервера, либо он недоступен."
"[english]vgui_Webkit_proxyconnectionproblem"	"Unable to connect to HTTP Proxy. Your proxy may be misconfigured or offline."
"vgui_HTMLCopyUrl"	"Скопировать адрес страницы"
"[english]vgui_HTMLCopyUrl"	"Copy Page URL"
"vgui_HTMLCopyLink"	"Скопировать адрес ссылки"
"[english]vgui_HTMLCopyLink"	"Copy Link Address"
"vgui_HTMLSearchMatch"	"%findactive% из %findcount%"
"[english]vgui_HTMLSearchMatch"	"%findactive% of %findcount%"
"vgui_HTMLSearchThisPage"	"Поиск"
"[english]vgui_HTMLSearchThisPage"	"Search this page"
"vgui_choosedirectoryname"	"Укажите название папки"
"[english]vgui_choosedirectoryname"	"Choose directory name"
"TextEntry_CopyAllToClipboard"	"Скопировать всё"
"[english]TextEntry_CopyAllToClipboard"	"Copy all text to clipboard"
"vgui_yes"	"Да"
"[english]vgui_yes"	"Yes"
"vgui_no"	"Нет"
"[english]vgui_no"	"No"
"vgui_HTMLCloseDevTools"	"Закрыть инструменты разработчика"
"[english]vgui_HTMLCloseDevTools"	"Close Developer Tools"
"vgui_HTMLOpenDevTools"	"Открыть инструменты разработчика"
"[english]vgui_HTMLOpenDevTools"	"Open Developer Tools"
"vgui_continue"	"Далее"
"[english]vgui_continue"	"Continue"
"vgui_ShuttingDown"	"Выключение..."
"[english]vgui_ShuttingDown"	"Shutting down..."
"vgui_HTMLInspectElement"	"Исследовать элемент"
"[english]vgui_HTMLInspectElement"	"Inspect Element"
}
}
