"lang"
{
"Language"	"danish"
"Tokens"
{
"TextEntry_Cut"	"Klip"
"[english]TextEntry_Cut"	"Cut"
"TextEntry_Copy"	"Kopier"
"[english]TextEntry_Copy"	"Copy"
"TextEntry_Paste"	"Indsæt"
"[english]TextEntry_Paste"	"Paste"
"TextEntry_SelectAll"	"Marker alt"
"[english]TextEntry_SelectAll"	"Select all"
"FileOpenDialog_Open"	"Åbn"
"[english]FileOpenDialog_Open"	"Open"
"FileOpenDialog_Cancel"	"Annuller"
"[english]FileOpenDialog_Cancel"	"Cancel"
"FileOpenDialog_Look_in"	"Se i:"
"[english]FileOpenDialog_Look_in"	"Look in:"
"FileOpenDialog_File_Name"	"Filnavn:"
"[english]FileOpenDialog_File_Name"	"File name:"
"FileOpenDialog_File_Type"	"Filtype:"
"[english]FileOpenDialog_File_Type"	"File type:"
"FileOpenDialog_Icon"	" "
"[english]FileOpenDialog_Icon"	" "
"FileOpenDialog_Name"	"Navn"
"[english]FileOpenDialog_Name"	"Name"
"FileOpenDialog_Type"	"Type"
"[english]FileOpenDialog_Type"	"Type"
"SysMenu_Minimize"	" Minimer "
"[english]SysMenu_Minimize"	" Minimize "
"SysMenu_Maximize"	" Maksimer "
"[english]SysMenu_Maximize"	" Maximize "
"SysMenu_Close"	" Luk "
"[english]SysMenu_Close"	" Close "
"Frame_Untitled"	"Unavngivet"
"[english]Frame_Untitled"	"Untitled"
"MessageBox_OK"	"OK"
"[english]MessageBox_OK"	"OK"
"PropertyDialog_OK"	"OK"
"[english]PropertyDialog_OK"	"OK"
"PropertyDialog_Cancel"	"Annuller"
"[english]PropertyDialog_Cancel"	"Cancel"
"PropertyDialog_Apply"	"Anvend"
"[english]PropertyDialog_Apply"	"Apply"
"QueryBox_Cancel"	"Annuller"
"[english]QueryBox_Cancel"	"Cancel"
"WizardPanel_Next"	"Næste >"
"[english]WizardPanel_Next"	"Next >"
"WizardPanel_Back"	"< Tilbage"
"[english]WizardPanel_Back"	"< Back"
"WizardPanel_Finish"	"Færdiggør"
"[english]WizardPanel_Finish"	"Finish"
"WizardPanel_Cancel"	"Annuller"
"[english]WizardPanel_Cancel"	"Cancel"
"vgui_ok"	"OK"
"[english]vgui_ok"	"OK"
"vgui_close"	"Luk"
"[english]vgui_close"	"Close"
"vgui_Cancel"	"Annuller"
"[english]vgui_Cancel"	"Cancel"
"vgui_select"	"Vælg"
"[english]vgui_select"	"Select"
"vgui_createfolder"	"Ny mappe..."
"[english]vgui_createfolder"	"New Folder..."
"vgui_next"	"Næste >"
"[english]vgui_next"	"Next >"
"vgui_back"	"< Tilbage"
"[english]vgui_back"	"< Back"
"vgui_CreateDirectoryFail_Title"	"Opret mappe – Fejl"
"[english]vgui_CreateDirectoryFail_Title"	"Create Folder - Error"
"vgui_CreateDirectoryFail_Info"	"Kunne ikke oprette en mappe, dette drev er skrivebeskyttet."
"[english]vgui_CreateDirectoryFail_Info"	"Failed to create a folder, this drive is read-only."
"vgui_CreateDirectoryFail_AlreadyExists"	"Mappen eksisterer allerede."
"[english]vgui_CreateDirectoryFail_AlreadyExists"	"That folder already exists."
"TextEntry_Language"	"Sprog"
"[english]TextEntry_Language"	"Language"
"TextEntry_ConversionMode"	"Konverteringstilstand"
"[english]TextEntry_ConversionMode"	"Conversion Mode"
"TextEntry_SentenceMode"	"Sætningstilstand"
"[english]TextEntry_SentenceMode"	"Sentence Mode"
"IME_English"	"Engelsk"
"[english]IME_English"	"English"
"IME_Chinese"	"Kinesisk"
"[english]IME_Chinese"	"Chinese"
"IME_Korean"	"Koreansk"
"[english]IME_Korean"	"Korean"
"IME_Hiragana"	"Hiragana"
"[english]IME_Hiragana"	"Hiragana"
"IME_FullWidthKatakana"	"Katakana i fuld bredde"
"[english]IME_FullWidthKatakana"	"Full-width Katakana"
"IME_FullWidthAlphanumeric"	"Alfanumerisk i fuld bredde"
"[english]IME_FullWidthAlphanumeric"	"Full-width Alphanumeric"
"IME_HalfWidthKatakana"	"Katakana i halv bredde"
"[english]IME_HalfWidthKatakana"	"Half-width Katakana"
"IME_HalfWidthAlphanumeric"	"Alfanumerisk i halv bredde"
"[english]IME_HalfWidthAlphanumeric"	"Half-width Alphanumeric"
"IME_General"	"Generelt"
"[english]IME_General"	"General"
"IME_BiasNames"	"Prioritering af navne"
"[english]IME_BiasNames"	"Bias for Names"
"IME_BiasSpeech"	"Prioritering af tale"
"[english]IME_BiasSpeech"	"Bias for Speech"
"IME_NoConversion"	"Ingen konvertering"
"[english]IME_NoConversion"	"No Conversion"
"IME_0404"	"Kinesisk (Taiwan)"
"[english]IME_0404"	"Chinese (Taiwan)"
"IME_0804"	"Kinesisk (PRC)"
"[english]IME_0804"	"Chinese (PRC)"
"IME_0409"	"Engelsk (USA)"
"[english]IME_0409"	"English (United States)"
"IME_0411"	"Japansk"
"[english]IME_0411"	"Japanese"
"IME_0412"	"Koreansk"
"[english]IME_0412"	"Korean"
"IME_0419"	"Russisk"
"[english]IME_0419"	"Russian"
"IME_041e"	"Thai"
"[english]IME_041e"	"Thai"
"IME_040c"	"Fransk (standard)"
"[english]IME_040c"	"French (Standard)"
"IME_0407"	"Tysk (standard)"
"[english]IME_0407"	"German (Standard)"
"IME_0410"	"Italiensk (standard)"
"[english]IME_0410"	"Italian (Standard)"
"IME_040a"	"Spansk (Spanien, traditionel form)"
"[english]IME_040a"	"Spanish (Spain, Traditional Sort)"
"vgui_FileCopyDialog_Title"	"Kopierer..."
"[english]vgui_FileCopyDialog_Title"	"Copying..."
"vgui_FileMoveDialog_Title"	"Flytter..."
"[english]vgui_FileMoveDialog_Title"	"Moving..."
"vgui_FileCopy_Estimate"	"%s1 tilbage"
"[english]vgui_FileCopy_Estimate"	"%s1 remaining"
"vgui_FileCopy_Copying_Multiple"	"Kopierer '%s1' (%s2 tilbage)"
"[english]vgui_FileCopy_Copying_Multiple"	"Copying '%s1' (%s2 remaining)"
"vgui_FileCopy_Copying_Single"	"Kopierer '%s1'"
"[english]vgui_FileCopy_Copying_Single"	"Copying '%s1'"
"vgui_FileCopy_Ovewwrite_Title"	"Overskriv fil(er)"
"[english]vgui_FileCopy_Ovewwrite_Title"	"Overwrite file(s)"
"vgui_FileCopy_Ovewwrite_Prompt"	"Overskriv '%filename%'?"
"[english]vgui_FileCopy_Ovewwrite_Prompt"	"Overwrite '%filename%'?"
"SMPEvent_AppLaunch"	"Start prog."
"[english]SMPEvent_AppLaunch"	"App Launch"
"SMPEvent_AppExit"	"Afslut prog."
"[english]SMPEvent_AppExit"	"App Exit"
"SMPEvent_Close"	"Luk"
"[english]SMPEvent_Close"	"Close"
"SMPEvent_FadeOut"	"Fade"
"[english]SMPEvent_FadeOut"	"Fade Out"
"SMPEvent_MediaBegin"	"Start medie"
"[english]SMPEvent_MediaBegin"	"Media Begin"
"SMPEvent_MediaEnd"	"Afslut medie"
"[english]SMPEvent_MediaEnd"	"Media End"
"SMPEvent_Play"	"Spil"
"[english]SMPEvent_Play"	"Play"
"SMPEvent_JumpHome"	"Spring til start"
"[english]SMPEvent_JumpHome"	"Jump Home"
"SMPEvent_JumpEnd"	"Spring til slutning"
"[english]SMPEvent_JumpEnd"	"Jump To End"
"SMPEvent_Pause"	"Pause"
"[english]SMPEvent_Pause"	"Pause"
"SMPEvent_Stop"	"Stop"
"[english]SMPEvent_Stop"	"Stop"
"SMPEvent_JumpFrom"	"Flyt fra"
"[english]SMPEvent_JumpFrom"	"Scrub From"
"SMPEvent_JumpTo"	"Flyt til"
"[english]SMPEvent_JumpTo"	"Scrub To"
"SMPEvent_StepFwd"	"Gå frem"
"[english]SMPEvent_StepFwd"	"Step Forward"
"SMPEvent_StepBack"	"Gå tilbage"
"[english]SMPEvent_StepBack"	"Step Backwards"
"SMPEvent_JumpFwd"	"Spring frem"
"[english]SMPEvent_JumpFwd"	"Jump Forward"
"SMPEvent_JumpBack"	"Spring tilbage"
"[english]SMPEvent_JumpBack"	"Jump Backwards"
"SMPEvent_Repeat"	"Gentag"
"[english]SMPEvent_Repeat"	"Repeat"
"SMPEvent_Maximize"	"Maksimer"
"[english]SMPEvent_Maximize"	"Maximize"
"SMPEvent_Minimize"	"Minimer"
"[english]SMPEvent_Minimize"	"Minimize"
"SMPEvent_Restore"	"Gendan"
"[english]SMPEvent_Restore"	"Restore"
"SMPStats_UserId"	"Bruger-id:"
"[english]SMPStats_UserId"	"User Id:"
"SMPStats_Filename"	"Filnavn:"
"[english]SMPStats_Filename"	"Filename:"
"SMPStats_EventTitle"	"Event"
"[english]SMPStats_EventTitle"	"Event"
"SMPStats_TimeTitle"	"Tid (ms)"
"[english]SMPStats_TimeTitle"	"Time (ms)"
"SMPStats_PositionTitle"	"Position (ms)"
"[english]SMPStats_PositionTitle"	"Position (ms)"
"SMPStats_DialogTitle"	"Dataindsamlingsindstillinger"
"[english]SMPStats_DialogTitle"	"Data Collection Preferences"
"SMPStats_DontAskAgain"	"Spørg ikke igen"
"[english]SMPStats_DontAskAgain"	"Don't ask again"
"vgui_Accept"	"Acceptér"
"[english]vgui_Accept"	"Accept"
"vgui_Decline"	"Afslå"
"[english]vgui_Decline"	"Decline"
"vgui_TimeLeftYearOrMore"	"over 1 år"
"[english]vgui_TimeLeftYearOrMore"	"more than 1 year"
"vgui_TimeLeftDay"	"%days% dag"
"[english]vgui_TimeLeftDay"	"%days% day"
"vgui_TimeLeftDays"	"%days% dage"
"[english]vgui_TimeLeftDays"	"%days% days"
"vgui_TimeLeftDayRemaining"	"%days% dag tilbage"
"[english]vgui_TimeLeftDayRemaining"	"%days% day remaining"
"vgui_TimeLeftDaysRemaining"	"%days% dag(e) tilbage"
"[english]vgui_TimeLeftDaysRemaining"	"%days% days remaining"
"vgui_TimeLeftHour"	"%hours% time"
"[english]vgui_TimeLeftHour"	"%hours% hour"
"vgui_TimeLeftHours"	"%hours% timer"
"[english]vgui_TimeLeftHours"	"%hours% hours"
"vgui_TimeLeftHourRemaining"	"%hours% time tilbage"
"[english]vgui_TimeLeftHourRemaining"	"%hours% hour remaining"
"vgui_TimeLeftHoursRemaining"	"%hours% timer tilbage"
"[english]vgui_TimeLeftHoursRemaining"	"%hours% hours remaining"
"vgui_TimeLeftMinute"	"%minutes% minut"
"[english]vgui_TimeLeftMinute"	"%minutes% minute"
"vgui_TimeLeftMinutes"	"%minutes% minutter"
"[english]vgui_TimeLeftMinutes"	"%minutes% minutes"
"vgui_TimeLeftMinuteRemaining"	"%minutes% minut tilbage"
"[english]vgui_TimeLeftMinuteRemaining"	"%minutes% minute remaining"
"vgui_TimeLeftMinutesRemaining"	"%minutes% minutter tilbage"
"[english]vgui_TimeLeftMinutesRemaining"	"%minutes% minutes remaining"
"vgui_TimeLeftSecond"	"%seconds% sekund"
"[english]vgui_TimeLeftSecond"	"%seconds% second"
"vgui_TimeLeftSeconds"	"%seconds% sekunder"
"[english]vgui_TimeLeftSeconds"	"%seconds% seconds"
"vgui_TimeLeftSecondRemaining"	"%seconds% sekund tilbage"
"[english]vgui_TimeLeftSecondRemaining"	"%seconds% second remaining"
"vgui_TimeLeftSecondsRemaining"	"%seconds% sekunder tilbage"
"[english]vgui_TimeLeftSecondsRemaining"	"%seconds% seconds remaining"
"vgui_TimeLeftDaysHours"	"%days% dage %hours% timer"
"[english]vgui_TimeLeftDaysHours"	"%days% days %hours% hours"
"vgui_TimeLeftDaysHour"	"%days% dage %hours% time"
"[english]vgui_TimeLeftDaysHour"	"%days% days %hours% hour"
"vgui_TimeLeftDayHours"	"%days% dag %hours% timer"
"[english]vgui_TimeLeftDayHours"	"%days% day %hours% hours"
"vgui_TimeLeftDayHour"	"%days% dag %hours% time"
"[english]vgui_TimeLeftDayHour"	"%days% day %hours% hour"
"vgui_TimeLeftDaysHoursRemaining"	"%days% dage %hours% timer tilbage"
"[english]vgui_TimeLeftDaysHoursRemaining"	"%days% days %hours% hours remaining"
"vgui_TimeLeftDaysHourRemaining"	"%days% dage %hours% time tilbage"
"[english]vgui_TimeLeftDaysHourRemaining"	"%days% days %hours% hour remaining"
"vgui_TimeLeftDayHoursRemaining"	"%days% dag %hours% timer tilbage"
"[english]vgui_TimeLeftDayHoursRemaining"	"%days% day %hours% hours remaining"
"vgui_TimeLeftDayHourRemaining"	"%days% dag %hours% time tilbage"
"[english]vgui_TimeLeftDayHourRemaining"	"%days% day %hours% hour remaining"
"vgui_TimeLeftHoursMinutes"	"%hours% timer %minutes% minutter"
"[english]vgui_TimeLeftHoursMinutes"	"%hours% hours %minutes% minutes"
"vgui_TimeLeftHoursMinute"	"%hours% timer %minutes% minut"
"[english]vgui_TimeLeftHoursMinute"	"%hours% hours %minutes% minute"
"vgui_TimeLeftHourMinutes"	"%hours% time %minutes% minutter"
"[english]vgui_TimeLeftHourMinutes"	"%hours% hour %minutes% minutes"
"vgui_TimeLeftHourMinute"	"%hours% time %minutes% minut"
"[english]vgui_TimeLeftHourMinute"	"%hours% hour %minutes% minute"
"vgui_TimeLeftHoursMinutesRemaining"	"%hours% timer %minutes% minutter tilbage"
"[english]vgui_TimeLeftHoursMinutesRemaining"	"%hours% hours %minutes% minutes remaining"
"vgui_TimeLeftHoursMinuteRemaining"	"%hours% timer %minutes% minut tilbage"
"[english]vgui_TimeLeftHoursMinuteRemaining"	"%hours% hours %minutes% minute remaining"
"vgui_TimeLeftHourMinutesRemaining"	"%hours% time %minutes% minutter tilbage"
"[english]vgui_TimeLeftHourMinutesRemaining"	"%hours% hour %minutes% minutes remaining"
"vgui_TimeLeftHourMinuteRemaining"	"%hours% time %minutes% minut tilbage"
"[english]vgui_TimeLeftHourMinuteRemaining"	"%hours% hour %minutes% minute remaining"
"vgui_TimeLeftMinutesSeconds"	"%minutes% minutter %seconds% sekunder"
"[english]vgui_TimeLeftMinutesSeconds"	"%minutes% minutes %seconds% seconds"
"vgui_TimeLeftMinutesSecond"	"%minutes% minutter %seconds% sekund"
"[english]vgui_TimeLeftMinutesSecond"	"%minutes% minutes %seconds% second"
"vgui_TimeLeftMinuteSeconds"	"%minutes% minut %seconds% sekunder"
"[english]vgui_TimeLeftMinuteSeconds"	"%minutes% minute %seconds% seconds"
"vgui_TimeLeftMinuteSecond"	"%minutes% minut %seconds% sekund"
"[english]vgui_TimeLeftMinuteSecond"	"%minutes% minute %seconds% second"
"vgui_TimeLeftMinutesSecondsRemaining"	"%minutes% minutter %seconds% sekunder tilbage"
"[english]vgui_TimeLeftMinutesSecondsRemaining"	"%minutes% minutes %seconds% seconds remaining"
"vgui_TimeLeftMinutesSecondRemaining"	"%minutes% minutter %seconds% sekund tilbage"
"[english]vgui_TimeLeftMinutesSecondRemaining"	"%minutes% minutes %seconds% second remaining"
"vgui_TimeLeftMinuteSecondsRemaining"	"%minutes% minut %seconds% sekunder tilbage"
"[english]vgui_TimeLeftMinuteSecondsRemaining"	"%minutes% minute %seconds% seconds remaining"
"vgui_TimeLeftMinuteSecondRemaining"	"%minutes% minut %seconds% sekund tilbage"
"[english]vgui_TimeLeftMinuteSecondRemaining"	"%minutes% minute %seconds% second remaining"
"vgui_Today"	"I dag"
"[english]vgui_Today"	"Today"
"vgui_Yesterday"	"I går"
"[english]vgui_Yesterday"	"Yesterday"
"vgui_Tomorrow"	"I morgen"
"[english]vgui_Tomorrow"	"Tomorrow"
"vgui_OnForDays"	"Varer %days% dage"
"[english]vgui_OnForDays"	"On for %days% days"
"vgui_OnForHours"	"Varer %hours% timer"
"[english]vgui_OnForHours"	"On for %hours% hours"
"vgui_OnForMinutes"	"Varer %minutes% minutter"
"[english]vgui_OnForMinutes"	"On for %minutes% minutes"
"vgui_OnForSeconds"	"Varer %seconds% sekunder"
"[english]vgui_OnForSeconds"	"On for %seconds% seconds"
"vgui_OnForDay"	"Varer %days% dag"
"[english]vgui_OnForDay"	"On for %days% day"
"vgui_OnForHour"	"Varer %hours% time"
"[english]vgui_OnForHour"	"On for %hours% hour"
"vgui_OnForMinute"	"Varer %minutes% minut"
"[english]vgui_OnForMinute"	"On for %minutes% minute"
"vgui_OnForSecond"	"Varer %seconds% sekund"
"[english]vgui_OnForSecond"	"On for %seconds% second"
"vgui_LastOnYearOrMore"	"Sidst online: mere end 1 år siden"
"[english]vgui_LastOnYearOrMore"	"Last Online: more than 1 year ago"
"vgui_LastOnDays"	"Sidst online: %days% dage siden"
"[english]vgui_LastOnDays"	"Last Online: %days% days ago"
"vgui_LastOnHours"	"Sidst online: %hours% timer siden"
"[english]vgui_LastOnHours"	"Last Online: %hours% hours ago"
"vgui_LastOnMinutes"	"Sidst online: %minutes% minutter siden"
"[english]vgui_LastOnMinutes"	"Last Online: %minutes% minutes ago"
"vgui_LastOnSeconds"	"Sidst online: %seconds% sekunder siden"
"[english]vgui_LastOnSeconds"	"Last Online: %seconds% seconds ago"
"vgui_LastOnDay"	"Sidst online: %days% dag siden"
"[english]vgui_LastOnDay"	"Last Online: %days% day ago"
"vgui_LastOnHour"	"Sidst online: %hours% time siden"
"[english]vgui_LastOnHour"	"Last Online: %hours% hour ago"
"vgui_LastOnMinute"	"Sidst online: %minutes% minut siden"
"[english]vgui_LastOnMinute"	"Last Online: %minutes% minute ago"
"vgui_LastOnSecond"	"Sidst online: %seconds% sekund siden"
"[english]vgui_LastOnSecond"	"Last Online: %seconds% second ago"
"vgui_TimeAgoYearOrMore"	"over 1 år siden"
"[english]vgui_TimeAgoYearOrMore"	"more than 1 year ago"
"vgui_TimeAgoDays"	"%days% dage siden"
"[english]vgui_TimeAgoDays"	"%days% days ago"
"vgui_TimeAgoHours"	"%hours% timer siden"
"[english]vgui_TimeAgoHours"	"%hours% hours ago"
"vgui_TimeAgoMinutes"	"%minutes% minutter siden"
"[english]vgui_TimeAgoMinutes"	"%minutes% minutes ago"
"vgui_TimeAgoSeconds"	"%seconds% sekunder siden"
"[english]vgui_TimeAgoSeconds"	"%seconds% seconds ago"
"vgui_TimeAgoDay"	"%days% dag siden"
"[english]vgui_TimeAgoDay"	"%days% day ago"
"vgui_TimeAgoHour"	"%hours% time siden"
"[english]vgui_TimeAgoHour"	"%hours% hour ago"
"vgui_TimeAgoMinute"	"%minutes% minut siden"
"[english]vgui_TimeAgoMinute"	"%minutes% minute ago"
"vgui_TimeAgoSecond"	"%seconds% sekund siden"
"[english]vgui_TimeAgoSecond"	"%seconds% second ago"
"FileOpenDialog_Col_Name"	"Navn"
"[english]FileOpenDialog_Col_Name"	"Name"
"FileOpenDialog_Col_Size"	"Størrelse"
"[english]FileOpenDialog_Col_Size"	"Size"
"FileOpenDialog_Col_Type"	"Type"
"[english]FileOpenDialog_Col_Type"	"Type"
"FileOpenDialog_Col_DateModified"	"Dato for modifikation"
"[english]FileOpenDialog_Col_DateModified"	"Date Modified"
"FileOpenDialog_Col_DateCreated"	"Dato for oprettelse"
"[english]FileOpenDialog_Col_DateCreated"	"Date Created"
"FileOpenDialog_Col_Attributes"	"Egenskaber"
"[english]FileOpenDialog_Col_Attributes"	"Attributes"
"FileOpenDialog_FileType_Folder"	"Filmappe"
"[english]FileOpenDialog_FileType_Folder"	"File Folder"
"FileOpenDialog_ToolTip_Up"	"Op"
"[english]FileOpenDialog_ToolTip_Up"	"Up"
"FileOpenDialog_ToolTip_NewFolder"	"Ny mappe"
"[english]FileOpenDialog_ToolTip_NewFolder"	"New Folder"
"FileOpenDialog_NewFolder_InputTitle"	"Ny mappe"
"[english]FileOpenDialog_NewFolder_InputTitle"	"New Folder"
"FileOpenDialog_NewFolderPrompt"	"Navn"
"[english]FileOpenDialog_NewFolderPrompt"	"Name:"
"FileOpenDialog_NewFolder_DefaultName"	"Ny mappe"
"[english]FileOpenDialog_NewFolder_DefaultName"	"New Folder"
"vgui_Webkit_error_title"	"Fejl"
"[english]vgui_Webkit_error_title"	"Error"
"vgui_Webkit_pagetypeunsupported"	"Siden kunne ikke indlæses; sideformatet understøttes ikke"
"[english]vgui_Webkit_pagetypeunsupported"	"Unable to load page, unsupported page format"
"vgui_Webkit_cachemiss"	"Din formularanmodning er udløbet. Klik på Genindlæs for at sende formulardataene igen."
"[english]vgui_Webkit_cachemiss"	"Your form request has expired. Click reload to re-submit the form data."
"vgui_Webkit_badurl"	"URL'en kunne ikke indlæses; forkert værtsnavn eller format"
"[english]vgui_Webkit_badurl"	"Unable to load URL, bad hostname or format"
"vgui_Webkit_connectionproblem"	"Kunne ikke oprette forbindelse til serveren. Serveren kan være offline, eller du har muligvis ingen forbindelse til internettet."
"[english]vgui_Webkit_connectionproblem"	"Unable to connect to server. Server may be offline or you may not be connected to the internet."
"vgui_Webkit_unknown"	"Websiden kunne ikke indlæses (ukendt fejl)."
"[english]vgui_Webkit_unknown"	"Failed to load web page (unknown error)."
"vgui_HTMLBack"	"Tilbage"
"[english]vgui_HTMLBack"	"Back"
"vgui_HTMLForward"	"Frem"
"[english]vgui_HTMLForward"	"Forward"
"vgui_HTMLReload"	"Genindlæs"
"[english]vgui_HTMLReload"	"Reload"
"vgui_HTMLStop"	"Stop"
"[english]vgui_HTMLStop"	"Stop"
"vgui_HTMLViewSource"	"Vis kilde..."
"[english]vgui_HTMLViewSource"	"View Source..."
"vgui_Webkit_error_header"	"Fejlkode:"
"[english]vgui_Webkit_error_header"	"Error Code: "
"vgui_Webkit_proxyconnectionproblem"	"Kan ikke oprette forbindelse til HTTP Proxy. Din proxy kan være konfigureret forkert eller offline."
"[english]vgui_Webkit_proxyconnectionproblem"	"Unable to connect to HTTP Proxy. Your proxy may be misconfigured or offline."
"vgui_HTMLCopyUrl"	"Kopier sidens URL"
"[english]vgui_HTMLCopyUrl"	"Copy Page URL"
"vgui_HTMLCopyLink"	"Kopier linkadresse"
"[english]vgui_HTMLCopyLink"	"Copy Link Address"
"vgui_HTMLSearchMatch"	"%findactive% af %findcount%"
"[english]vgui_HTMLSearchMatch"	"%findactive% of %findcount%"
"vgui_HTMLSearchThisPage"	"Søg på siden"
"[english]vgui_HTMLSearchThisPage"	"Search this page"
"vgui_choosedirectoryname"	"Vælg mappenavn"
"[english]vgui_choosedirectoryname"	"Choose directory name"
"TextEntry_CopyAllToClipboard"	"Kopier al tekst til udklipsholderen"
"[english]TextEntry_CopyAllToClipboard"	"Copy all text to clipboard"
"vgui_yes"	"Ja"
"[english]vgui_yes"	"Yes"
"vgui_no"	"Nej"
"[english]vgui_no"	"No"
"vgui_HTMLCloseDevTools"	"Luk udviklerværktøjer"
"[english]vgui_HTMLCloseDevTools"	"Close Developer Tools"
"vgui_HTMLOpenDevTools"	"Åbn udviklerværktøjer"
"[english]vgui_HTMLOpenDevTools"	"Open Developer Tools"
"vgui_continue"	"Fortsæt"
"[english]vgui_continue"	"Continue"
"vgui_ShuttingDown"	"Lukker ned..."
"[english]vgui_ShuttingDown"	"Shutting down..."
"vgui_HTMLInspectElement"	"Inspicer element"
"[english]vgui_HTMLInspectElement"	"Inspect Element"
}
}
